harvest	n. 收获(期),成果,收获物 vt.& vi. 收割,收获
personnel	n.全体员工； （与复数动词连用）人员，员工； 人事部门
monthly	adj. 每月的，持续一个月的，每月发生的 adv. 每月, 按月 n. 月刊 n.(复数）monthlies:月经
dismiss	vt.解雇，把…免职； 遣散，解散（队伍等）； 驳回，拒绝受理； 搁置 vi.解散
specification	n. 规格,详述,详细说明书
entitle	v. 取名为,给与名称,叫做,使有权利
accelerate	vt. 加速,提前,跳级 vi. 加速
embryo	n. 胚胎,萌芽
conscious	adj. 神志清醒的,意识到的,自觉的,有意的 n. 意识
dig	v. 挖, 翻土
pink	adj. 粉红色的,激进的 n. 粉红色,石竹花,典范 vt. 刺
spin	n. 旋转, 疾驰 v. 纺织, 旋转, 拉长
hedge	n. 树篱,防止财产损失的方法 vt. 包围,限制 vi. 种树篱,拐弯抹角,保护自己不受财产损失 adj. 树篱的,篱笆边的
chest	n. 胸, 大箱子, 金库, 资金, 一箱, 密封室, 衣橱
interrupt	n. 中断 vt. 打断,妨碍 vi. 插嘴 [计算机] 中断
tower	n. 塔,高楼,堡垒 vi. 屹立,超越
spoil	n. 战利品, 奖品 v. 宠坏, 溺爱, 破坏, 腐坏
bay	adj. 红棕色 n. 红棕色,隔间,配电间,犬吠,围困,海湾,月桂树,名望 vi. 嗥叫 vt. 吼叫着追赶或进攻,哀号,把...围困住
priest	n. 教士, 神父
particle	n. 微粒,质点,极小量
namely	adv. 即, 也就是
nasty	adj.肮脏的； 下流的，令人讨厌的； 恶劣的，艰险的； 严重的 n.令人不愉快的事物
tale	n. 叙述,传说,故事
servant	n. 仆人
species	n. [生物] 物种；种类 adj. 物种上的
surplus	adj. 多余的,过剩的 n. 过剩,剩余物,盈余,顺差
translate	vt. 翻译；转化；解释；转变为；调动 vi. 翻译
functional	adj. 功能的,有功能的,实用的
scenario	n. 情节梗概, 剧本
authorize	v. 授权与,批准,委托代替
stake	n. 木桩,赌注,股份 vt. 打赌,下赌注；用桩支撑
mortgage	vt. 抵押 n. 抵押；房屋抵押贷款
flag	n. 旗标,旗子,信号旗 vt. 打旗号 vi. 无力地下垂,减退
fourteen	num. 十四
gently	adv. 轻轻地, 温柔地
statistical	adj. 统计的, 统计学的
deficit	n. 赤字,不足，缺乏
raw	adj. 生的,未加工的,原始的,不熟练的,寒冷的 n. 触到某人的痛处
possess	v. 持有,克制,为...着迷
steel	n. 钢,钢制品,坚强 adj. 钢的,如钢铁般的,非常坚强的 vt. 包钢, 使坚硬, 使下定决心
cognitive	adj. 认知的,认识的,有认识力的
clue	n. 线索 vt. 提示
sacrifice	n. 牺牲,供俸,祭品 vt. 牺牲,祭祀,贱卖 vi. 献祭,(棒球)作牺牲一击
analyst	n. 分析家
legend	n. 传说,传奇人物,铭文
dose	n. 剂量,服用量 vt. 配
hurry	n. 骚乱,匆忙, 急需 vt. 催促, 加快, 迅速处理 vi. 快速移动
drag	n. 用来拖拉的东西,拖,拖累 vt. 拖累,拖拉(动) vi. 拖拉(动),缓慢地行走
twin	n.孪生儿之一，双胞胎之一； 两个相像的人或物之一； 孪晶； 双人床 vt.尤用于英国)使结成姊妹城市； 使（两人或两事物）紧密结合； 使偶合； 使相连 adj.成对的； 成双的； 双重的； 双联的
satellite	n. 卫星,卫星城,随从
trigger	vt. 引发，引起；触发 vi. 松开扳柄 n. 扳机；[电子] 触发器；制滑机
strict	adj. 严格的, 精确的, 完全的
drift	n. 漂移,漂流物,观望,漂流,吹积物,趋势 vi. 漂移,漂流,吹积 vt. 使漂流,把...吹积
stroke	n. 中风；冲程；笔画；打击；尝试；轻抚 vt. 抚摸；敲击；划尾桨；划掉 vi. 击球；作尾桨手；敲击键盘
underground	adj. 地下的, 秘密的 adv. 在地下, 秘密地 n. 地下, 地铁, 地道, 秘密活动
structural	adj. 结构的, 构造的，建筑的，建筑用的
fluid	adj. 流畅优美的,流体的,流动的,不稳定的 n. 流体,液体
privilege	n. 特权,特别恩典,基本人权,荣幸 vt. 给特权,免除
mutual	adj. 共同的,相互的
unhappy	adj. 不快乐的,不幸的,不适当的
bicycle	n. 自行车 v. 骑自行车
anxious	adj. 焦急的, 忧虑的
gear	n. 齿轮,传动装置,设备,工具 vt. &vi. 使适应于,以齿轮连起,配搭活动,调整
sophisticate	n. 久经世故的人 vt. 玩弄诡辩,掺合,弄复杂
traveler	n. 旅行者(移式起重机, 导丝钩, 临时记帐单)
lease	n. 租约,租期,租 v. 出租,租出,租得
versus	prep. 对；与...相对；对抗
ocean	n. 海洋,大量
steam	vt. 蒸，散发；用蒸汽处理 n. 蒸汽；精力 vi. 蒸，冒水汽 adj. 蒸汽的
ex	prep. 在 ... 交货 pref. 之前的，前任的
blanket	n. 毛毯,覆盖物,排字版 vt. 用毯子裹,扑灭,挡风,覆盖,使包含 adj. 包含所有的,适用于所有情形的
blast	n. 爆破,冲击波,气流,一阵,汽笛声 vi. 爆破,突然发出声音 vt. 喷射,炸掉
asleep	adj. 睡着的,已死的，不活跃的，麻木的 adv. 处于或进入睡眠状态地，陷入麻木不仁状态地
log	n. 记录,圆木,日志,计程仪 vt. 伐木,切,记录,航行,度过(时间) vi. 采伐
logic	n. 逻辑(学),逻辑性,合理的推理
logical	adj. 符合逻辑的,逻辑上的,有推理能力的
decorate	vt. 装饰, 装修, 授予某人奖章或其他奖状
gender	n. 性,性别 vt.& vi. 产生,发生
silly	adj. 愚蠢的,淳朴的,晕的
seventy	七十
holder	n. 持有者，占有者，（台、架等）支持物
homework	n. 家庭作业
humor	n. 幽默,诙谐,心情 v. 迎合,牵就,顺应
web	n. 网
abstract	n. 摘要,抽象的东西 adj. 抽象的,理论的 vt. 移除,摘要,偷 vi. 做摘要
efficiency	n. 效率；效能；功效
valid	adj. 有确实根据的; 有效的; 正当的, 合法的
accent	n. 重音,口音,强调 vt. 重读,强调
bacteria	n. (复数)细菌
loose	n. 解放, 放任, 放纵 adj. 宽松的, 不牢固的, 不精确的 v. 释放, 放枪, 开船
punish	惩罚, 处罚
bowl	n. 碗, 物体的碗状部分, 季后赛, 圆形露天剧场 vi. 打保龄球, 快速移动 vt. 投球, 投球得分
pregnant	adj. 怀孕的，意味深长的,含蓄的，富于想象力的
genuine	adj. 真正的,真实的,诚恳的
castle	n. 城堡 vt. 置于城堡中,(棋)移动王车易位 vi. (棋)移动王车易位
verb	n. 动词
swell	n. 增大,隆起的部分, 波浪 adj. 优秀的, 时髦的 vi. 渐增, 膨胀, 积聚, 情感迸发 vt. 使情感迸发, 扩大, 使膨胀
loud	adj. 大声的,吵闹的,难闻的 adv. 响亮地,大声地
conventional	adj. 普通的,常见的,习惯的,常规的
productivity	n. 生产率, 生产能力
beg	vt. 乞讨，恳求，合理需要 vi. 行乞，乞求 abbr. （begin）的缩写，开始
profound	adj. 极深的,深奥的,深厚的,严重的
civilian	adj. 平民的 n. 罗马法专家,平民
shade	n. 色度,荫凉处,稍微 vt. &vi. 渐变,遮蔽,微减
magic	adj. 有魔力的, 神奇的 n. 魔法, 魔术 vt. 使用魔(变出等)
agricultural	adj. 农业的
virtue	n. 美德,优点;贞操
clip	n. 夹子,别针,回形针,修剪,剪下来的东西 vt. &vi. 修剪,剪报,痛打,紧紧围住
poster	n. 海报,招贴,脚夫 v. 贴海报于
officially	adv. 官方地, 正式地，公务上, 职务上
shell	n. 贝壳,壳,外形 vt. &vi. 去壳,脱落,炮击,拾贝壳 n.[计算机] DOS命令 : 安装备用的COMMAND.COM文件, 并改变环境尺寸
shelter	n. 庇护所,避难所,庇护 vt. &vi. 庇护,保护,隐匿
oral	adj. 口头的 n. 口试
orange	adj. 橙色的 n. 橘子,橙黄色
offense	n. 犯罪, 伤感情, 攻击, 得分率
broadcast	n. 广播,广播节目 adj. 广播的 vt.& vi. 广播 adv. 经广播,四散地
organ	n. 风琴,器官,机构,机关报刊
airline	n. (飞机的)航线,航空公司
independence	n. 独立, 自主, 自立
indication	n. 象征,迹象,指示,表示
coordinate	n. 同等的人物; (色调, 图案, 样式等)配套服装 adj. 同等的, 等位的; (大学)男女分院制的 v. 协调, 整合; 使一致 [计算机] 坐标
bull	adj. 大型的,公牛的,雄性的 n. 公牛,买空着,像牛的东西,斗牛犬,教宗训谕,法令 vi. 猛冲 vt. 暴力,强制
compensation	n. 补偿, 赔偿; 赔偿金, 物
equip	v. 装备, 设, 穿～
inevitable	adj. 不可避免的, 必然(发生)的
recipe	n. 食谱,处方,秘诀
leather	adj. 皮革制的 n. 皮革 vt. 用皮革覆盖, 鞭打
rational	adj. 合理的,理性的,能推理的 n. 有理数
mortality	n. 必死的命运,死亡数目,死亡率
creature	n. 生物, 动物, 人
tank	n. 水槽,池塘,战车 vt. 储于槽中,击败 vi. 放弃
tap	n. 轻打, 水龙头, 电话窃听 vt. 从...放出液体, 自...某人处获取, 在...上装窃听器, 轻拍 vi. 轻拍
react	vt. 作出反应 vi. 起反应, 起作用, 反攻
wealthy	adj. 富有的 n. 富人
button	n. 钮扣,徽章,像纽扣的东西,未成熟的蘑菇,按钮 vt. 用纽扣装饰,钉纽扣,闭嘴 vi. 扣上
democrat	n.民主主义者，民主人士； 民主党人； <美>民主党党员
replacement	n. 交换,更换,代替者
constraint	n. 约束, 强制, 约束条件, 对感情的压抑, 虚情假意 [计算机] 限制
similarly	adv. 相似地, 类似地
opera	n. 歌剧 n. 挪威Opera软件公司的浏览器软件
incredible	adj. 难以置信的, 惊人的
weigh	vt. 权衡；考虑；称…重量 vi. 重量为…；具有重要性；成为…的重荷；起锚 n. 权衡；称重量
anticipate	vt. 预期，期望；占先，抢先；提前使用
crystal	adj. 清澈透明的, 晶体的 n. 水晶, 结晶
correlation	n. 相互关系,相关,关连
excess	adj. 过量的,附加的 n. 超过,超越,过度,过量
exam	n. =examination 考试
underneath	adv. 在下面 n. 下部, 底部 prep. 在...下面
resemble	v. 相似, 类似, 像
initiate	n. 创始人 adj. 新加入的 vt. 开始,创始,启蒙,介绍加入
technological	adj. 科技的，工艺的
situate	vt. 位于, 坐落在 adj. 位于...的，坐落在...的
ritual	n. 仪式,典礼,宗教仪式,固定程序 adj. 仪式的,依仪式而行的，老规矩的，惯常的
painful	adj. 痛苦的
meantime	adv. 与此同时 n. 其时, 其间
thrust	n. 推力,刺,力推 vt.& vi. 插入,推挤,刺
preference	n. 偏爱,优先,喜爱物
cow	n. 母牛, 母兽 vt.恐吓
qualification	n. 资格, 条件, 限制
weekly	n. 周刊, 周报 adj. 每周的, 一周一次的, 周刊的 adv. 每周, 一周一次
happiness	n. 快乐,幸福,适当
architecture	n. 建筑学, 建筑业, 建筑物, 结构 [总称]建筑物, 建筑风格
exit	n. 出口,退场,离去 vi. 退出,死亡 vt. 离开
regulate	v. 有系统的管理,规定,调节
widespread	adj. 分布(或散布)广的,普遍的
invasion	n. 侵入, 侵略
segment	n. 部分 v. 部分,段,分割 vt. 分割
pleasant	adj. 令人愉快的,舒适的
sensitivity	n. 敏感, 多愁善感, 感受性
reliable	adj. 可靠的,可信的
reluctant	adj. 不情愿的,勉强的
deliberately	adv. 慎重地,故意地
importantly	adv. 重要地
thoroughly	adv. 彻底地
smooth	adj. 平稳的,流畅的,安祥的,圆滑的,搅拌均匀的 vt. 使光滑,磨光,安慰,理顺(羽毛) vi. 变光滑
deck	n. 甲板,桥面,楼层 vt. 装饰
midnight	n. 午夜，漆黑
interior	adj. 内部的,内地的,国内的,在内的 n. 内部
assembly	n. 集合, 集会, 装配
query	n. 疑问,疑问号,质问 vt. 询问,表示怀疑
tourism	n. 旅游业,观光,游览
fade	vi. 褪色,消失,凋谢 vt. 使褪色 n. 淡入,淡出 adj. 平凡的,乏味的
carrier	n. 运送者,行李架, 客运公司, 运输工具,航空母舰,带菌者,电信公司
defect	n. 缺点 vi. 背叛
similarity	n. 相似, 类似
journal	n. 日记, 杂志, 日报
ambitious	adj. 热望的, 有雄心的, 有抱负的
handful	n. 少数,一把,棘手之事 n. 【非正式用语】 难以控制的人或费劲的事
diminish	vt. 减少,变小, 减损 vi. 变少, 逐渐变细
rescue	n. 援救,解救,营救队 vt. 援救,救出,营救
pencil	n. 铅笔 v. 用铅笔写
workshop	n. 车间, 工场, 研讨会, 讲习班
bell	n. 钟,铃,花冠,吼叫声 vt. 敲钟,使象钟状地张开 vi. 使呈钟状,张开
occasionally	adv. 偶尔地
residence	n. 住处, 住宅, 居住
tide	n. 潮,趋势,潮流 vt. 使...随潮漂流 vi. 涌动
resort	n. (渡假)胜地, 手段, 凭借 vi. 诉诸, 常去
moderate	adj. 适度的, 稳健的, 温和的, 中等的 v. 节制, 使...稳定, 使...缓和 n. 稳健的人
cattle	n. 牛 n. 家畜，马，无价值的人，畜牲
desert	n. 沙漠,荒地,应得(的惩罚或奖励)adj. 沙漠的,荒凉的vt. 遗弃vi. 擅离职守
cease	n. 停止 vt. &vi. 停止,终了
worldwide	adj. 全世界的
poem	n. 诗
destination	n. 目的地,终点,景点
restriction	n. 限制,约束 vi. 结果,(作为结果)发生
infrastructure	n. 下部构造, 下部组织, 基础结构, 基础设施
dominant	adj. 占优势的，主导的，显性的 n. 主宰者
mid	adj. 中间的，[语]央元音的 prep. 在 ... 的中间 abbr. 移动互联网设备 (=Mobile Internet Device)
retreat	n. 休息寓所,撤退,隐居 vt. &vi. 撤退, 向后倾
champion	n. 冠军, 拥护者, 勇士 vt. 保卫, 拥护
piano	n. 钢琴 adj. &adv. 轻柔的
happily	adv. 幸福地, 快乐地, 幸好 形容词happy的副词形式
alliance	n. 结盟,联盟,联姻 Alliance [地理名词]
allocate	v. 分派, 分配, 分配额
manuscript	adj. 手抄的 n. 手稿, 原稿
rid	vt. 免除,清除,使...获自由
chase	n. 追求,狩猎 v. 追捕,追逐,在金属上打花样
specialize	vi.专门从事； 专攻； 详细说明； 特化 vt.使专门化； 使适应特殊情况； 详细说明； 列举
heal	vt. 痊愈,恢复,和解 vi. 痊愈
fence	n. 围墙, 剑术 v. 用篱笆围住, 练习剑术, 防护 [计算机] 栅栏
extraordinary	adj. 非凡的,特别的,特派的
gallery	n. 美术馆, 画廊, 顶层楼座, 狭长的房间
infant	adj. 婴儿的, 幼稚的, 初期的 n. 婴儿, 幼儿
chicken	n. 鸡,鸡肉,胆小,懦夫 adj. 懦弱的,胆小的
bloody	adj. 流血的,血腥的,嗜杀的 vt. 使流血 adv. [俚]非常
minimize	v. 将...减到最少 [计算机] 最小化
merge	vt. &vi. 合并,消失,吞没, 融合 [计算机] 合并
ally	n. 盟友,同盟国 vt. &vi. 联盟,联合，同盟
parameter	n. 参数,参量,决定因素
transform	vt. 转换,变形 vi. 改变 n. 变形
clinical	adj. 临床的
stability	n. 稳定性,居于修道院
plug	n. 塞子,消防栓,电插头 vt. 塞住,射杀,宣传 vi. 射杀,持续的工作
transportation	n. 运输, 运输系统, 运输工具
stamp	n. 印,邮票,打印器 vt. 捺印,顿足,贴上邮票
click	n. 点击,滴答声,拍答声 vt. 点击,作滴答声,使...作拍答声 vi. 击打,完全符合,成功,以点击的方式选择
tackle	n. 工具,复滑车,扭倒 vt. &vi. 处理,抓住
strip	vi.剥光； 表演脱衣舞； 剥除 vt.除去，剥去； 剥夺； 删除； 清除，拆除 n.长条，条板； 带状地带（或森林、湖面等）； （足球队员的）运动服
explicit	adj. 明确的,详述的，明晰的,外在的
publisher	n. 出版者, 发行人
rub	n. 摩擦,困难,障碍 vt. 擦, 搓, 涂抹上, 使不愉快 vi. 摩擦
consensus	n. 共识，一致，合意 n. [生理]交感
flexible	adj. 灵活的,易弯曲的,柔韧的,可变通的
divorce	n. 离婚 v. 与...办离婚
ruin	n. (pl.)废墟,毁灭 v. 毁坏,破坏 vi. (使)破产,毁灭 vt. 毁坏,毁灭
consultant	n. 顾问, 咨询专家
norm	n. 标准,规范
railway	n. 铁路 v. 由铁道运输
curriculum	n. 课程，全部课程
triumph	n. 凯旋,欢欣 vi. 得胜,成功,庆功
fool	n. 愚人,受骗者 vt. 愚弄,欺骗 vi. 干傻事,开玩笑 adj. 愚蠢的
considerably	adv. 非常地, 很, 颇
blend	vt. &vi. 混合 n. 混合物
diversity	n. 多样化，（人在种族、民族、宗教等方面的）多样性； 差异； 分歧 vt. 使不同,使多样化
adventure	n. 冒险,奇遇 vt. 冒险,尝试 vi. 大胆进行,冒险
sake	n. 缘故, 利益, 好处
precise	adj. 精确的,准确的,认真的
domain	n. 领域 [计算机] 域
preliminary	n. 初步行动, 准备, 初步措施 adj. 初步的, 开始的, 预备的
twist	n. 卷曲物,旋转,扭曲,曲解,转折(体) vt. 拧,缠绕,扭(曲) vi. 蛇行,变形,转
ultimate	n. 终极,根本，精华 adj. 终极的,根本的,极限的,最后的
competence	n. 能力,管辖权,技能
elite	n. 精华, 精锐, 中坚份子
fortunately	adv. 幸运地,幸亏
informal	adj. 非正式的,不拘形式的
scatter	n. 散布, 零星少量 vt. 驱散, 散播 vi. 分散, 消散
foundation	n. 基础；地基；基金会；根据；创立
pure	adj. 纯的, 纯洁的, 纯理论的, 抽象的, 完全的
buyer	n. 买主, 买方
fragment	n. 碎片 vt. &vi. 变成碎片 [计算机] 碎片
excitement	n. 激动, 兴奋
lifestyle	n. 生活方式
bid	n. 出价,邀请竞标 vt. 命令,吩咐,投标,出价 vi. 出价
stupid	adj. 愚蠢的,笨拙的，麻木的，无趣味的 n. 傻瓜
impressive	adj. 给人深刻印象的
oblige	vt. 强制, 施恩惠 vi. 帮忙
lip	n. 嘴唇
liquid	adj. 液体的, 液态的 n. 液体
frequent	adj. 经常的,频繁的 vt. 常到,常去
attachment	n. 附件, 附著, 附属物, 依恋, 忠诚，依赖 [法律]扣押令
format	n. 设计,版式 n.[计算机]格式,DOS命令 : 格式化(磁盘),用于空盘或使用过的磁盘建立新空盘来存储数据 v. vt.使格式化,设计,安排
correctly	adv.恰当地,正确地
frighten	v. 使惊吓, 惊恐
pig	n. 猪
dust	n. 灰尘,无价值之物,屈辱状态 vt. 拂去灰尘, 撒上粉状物体,大胜 vi. 擦拭灰尘
sunny	adj. 阳光充足的,晴朗的,明媚的
composition	n. 作文,著作,组织,合成物，成份
blank	adj. 空白的, 茫然的, 全部的, 面无表情的, 未完工的 n. 空白(处), 空隙, 空虚, (有弹药而无弹头的)空弹 vi. 消失, 走神 vt. 使模糊不清, 删除, 封闭, (比赛时连续得分)使对手得零分
compromise	n. 妥协, 折衷, 折衷案 vt. 妥协处理, 危害 vi. 妥协, 让步
artificial	adj. 人造的,虚伪的,武断的
pride	n. 高傲,自豪,自尊,一群狮子 vt. 以...自豪
summary	n. 摘要,概要 adj. 摘要的,简略的
upward	adj. 向上的, 上升的 adv. 向上, 上升
concrete	n. 水泥,混凝土 adj. 具体的,实在的,水泥的 vt. &vi. 凝结,结合
uncertain	adj. 不确定的
aunt	n. 伯母, 姑, 婶, 姨
exclusive	adj. 独占的, 唯一的, 排外的; 高价的, 时髦的 [计算机] 互斥的 n. 独家新闻, 独权
absorb	v. 吸收,吸引...的注意,使全神贯注
bath	n. 洗澡,洗澡水,浴盆,浴室,财政亏损,(复)游泳池 n. (Bath)巴斯(英国城市) vt. &vi. 洗澡
partnership	n. 合伙, 合股
separately	adv. 分别地；分离地；个别地
capability	n. 能力,才能,性能,容量
consciousness	n. 意识,知觉,自觉,觉悟
beneath	adv. 在下方 prep. 在下方,在...之下
conservation	n. 保存, 防止流失, 守恒, 保护自然资源
punishment	n. 惩罚
behave	vt. &vi. 举止,行为,举止端正
purely	adv. 纯粹地 adv. 清洁地, 贞淑地
electric	adj. 电的,令人激动的,鲜亮的 n. 供电
accuracy	n. 准确(性), 精确度
actively	adv.活跃地,积极地
terribly	adv. 可怕地，极坏地 非常地，很
vulnerable	adj. 易受伤害的, 有弱点的
beam	n. 光线，电波，横梁，容光焕发 vt. 发出（光、电、热、信号）；为……上梁 vi. 微笑；发光
cite	vt. 引用,引证,传讯,嘉奖
admission	n. 许可, 入会费, 承认
historic	adj. 有历史意义的
golf	n. 高尔夫球 v. 打高尔夫球 vi. (打)高尔夫球
operator	n. 操作员,管理者,技工,报务员
myth	n. 神话
prompt	adj. 迅速的, 敏捷的, 立刻的 vt. 激起, 促进, 推动; 提示 vi. 提示 n. 提示; 提示的内容 n. [商]付款期限
quit	v. 离开,辞职,停止
ghost	n. 鬼,幽灵,一丝 vt. &vi. 像(鬼一样)地行进
giant	adj. 巨大的 n. 巨人,伟人,巨大的东西
faithfully	adv. 忠实, 诚心诚意, 深信着
array	n. 数组,(陈)排列,大批,一系列 vt. 排列,布署,打扮
voluntary	adj. 自愿的, 志愿的 n. (教堂礼拜仪式前后或进行期间的)乐器独奏
correspond	vi. 符合,通信,相当
grab	vt. &vi. 抓取,抢去，吸引注意 n. 抓,接应,掠夺 n.不法所得； 被抓住的人； 抓取装置
adoption	n. 采用, 采纳, 收养
rail	n. 栏杆,铁轨,扶手 vt. 以横木围栏,铺铁轨 vi. 责骂, 抱怨
brush	n. 刷子,画笔,轻擦,小冲突, 灌木丛 vt. 用刷子清洗,画,拭去,打发 vi. 轻擦,拂拭
radical	n. 激进份子,原子团,激进派 adj. 急进的,根本的,激进的,基本的,彻底的
commodity	n. 商品, 日用品
performer	n. 表演者, 执行者
guideline	n. 指引，指导方针
comply	vi. 顺从,答应
inherit	vi. 继承 vt. 继承,遗传
vocabulary	n. 词汇, 词汇量
reasonably	adv. 适度地, 相当地，合理地，有理性地
mature	adj. 成熟的, 到期的, 充分发育的, 考虑周到的 vt. 使...成熟, 长成 vi. 长成, 成熟; 到期
inner	adj. 内部的,里面的,内心的 n. 里面,内部
confront	vt. 面临, 对抗, 遭遇
margin	n. 差额,利润,页边空白,边缘 vt. 使围绕于,加边缘
significance	n. 意义,重要性
insect	n. 昆虫
mall	n. 林荫大道,商业街,购物商场
evil	adj. 邪恶的, 坏的 n. 邪恶, 罪恶
spectacular	adj. 壮观的, 令人惊叹的 n. 惊人之举, 壮观的表演或影视作品
overseas	adj. 海外的 adv. 在海外
inevitably	adv. 不可避免地
gradually	adv. 逐渐地
counsel	n. 商议, 忠告, 法律顾问 v. 商议, 劝告
linguistic	adj. 语言的, 语言学的
tactic	n. 战略,策略 adj. 战术的,有策略的
intensity	n. 激烈,强度,强烈,剧烈
tendency	n. 趋势,倾向
reflection	n. 反映,映像,折射,沉思,影响
innovation	n. 创新, 革新
whilst	conj. 当...时, 可是, 虽然,只要
grandmother	n. (外)祖母
grammar	n. 语法
sketch	n. 素描,草图,概述,小品 vt. 描绘略图 vi. 写生
pump	n. 抽水机, 打气筒, 心脏, 抽水, 轻软舞鞋 vt. 抽水, 打气, 用泵输送, 盘问, 涌出 vi. 用泵抽水, 快速上下(或内外)运动
dare	n. 敢, 挑战 aux. 敢 vi. 敢 vt. 敢于, 勇于面对
cigarette	n. 香烟
ski	adj. 滑雪（用）的 n. 滑雪，滑雪板 vt. & vi. 滑雪
deem	v. 认为, 相信
theoretical	adj. 理论上的
thereby	adv. 因此,从而
cancel	n. 取消,撤消 vt. 取消,删去, 约分 vi. 抵消
iron	adj. 刚强的 n. 铁, 熨斗, 坚强, (复数)铁制物 vt. 熨烫(平), 用铁装备 vi. 熨烫(平)
exposure	n. 面临（困难），显露，暴露,揭露,曝光
wise	adj. 明智的,有学问的,有智慧的,聪明的 n. 方式 vt. 引导 vi. 学
jail	n. 监牢,监狱,拘留所 vt. 监禁,下狱
jam	n. 果酱,拥塞之物,堵塞, 窘境 vt. &vi. 挤,塞满,混杂
captain	n. 船长, 队长, 首领 vt. 率领, 指挥
removal	n. 移动, 移居, 除去
renew	vt. 使更新,复始,使恢复,补充 vi. 更新,重新开始
assemble	vt. 聚集,集合,装配 vi. 集合, 聚集
proposition	n. （难办或诱人的）事情，任务；见解；观点；（美国的）法律修正案；提议；建议；提案 vt. 向…提出下流的要求；向…提出猥亵的要求
script	n. 原稿,手稿,脚本 vi. 写剧本
soap	n. 肥皂 vt. 用肥皂洗,阿谀奉承
residential	adj. 住宅的,与居住有关的
disability	n. 无力, 无能, 残疾
disappointment	n. 失望，令人失望的人或事
peaceful	adj. 安宁的, 和平的
terminal	n. n. 终端机,终点,末端 adj. 终点的,晚期的,致死的
mirror	n. 镜子 vt. 反映,反射
briefly	adv. 简短地,简单的
missile	n. 导弹,投射物
junior	adj.较年幼的，较年小的； 三年级的，低年级的； 资历较浅的； 后进的 n.年少者，青少年； 晚辈； 三年级生； 职位较低者
depart	vt. 离开 vi. 离开,死亡,脱轨
precious	adj. 宝贵的,珍贵的,矫揉造作的 adv. 极其地
resistance	n. 抵抗力,反抗,反抗行动;阻力,电阻;反对 adj. 抵抗的
fancy	n. 想像力, 幻想, 喜好, 爱 adj. 想像的, 时髦的, 华丽装饰的, 奢侈的, 技巧的 vt. 想象, 自认为, 喜好
comedy	n. 喜剧,滑稽, 幽默事件
modest	adj. 谦虚的, 适度的, 端庄的
wound	vbl. 嗅出,吹号角(wind的过去式和过去分词) n. 创伤,伤害,苦痛 vt. &vi. 伤害
wrap	vt.包；缠绕；用…包裹（或包扎、覆盖等）:掩护 n.膝毯，披肩，围巾，围脖，头巾，罩衫，外套，大衣； 包装纸:〈俚〉机密 vi.缠绕，盘绕（通常与 over, around 等连用）；包上，裹上:穿上衣服等
molecule	n. 分子
tin	n. 锡,马口铁,罐 vt. 在...上镀锡
legitimate	adj. 合法的, 正当的, 合理的, 世袭的 vt. 使合法, 授权, 宣布...为合法
adviser	n.顾问,<美> (学生的)指导老师
clause	n. 分句, 从句, 条款, 款项
administer	vt. 管理,执行,给与 vi. 执行管理人职责,给与帮助
span	n.共轭（马、骡）； 跨度，墩距； 一段时间； [航] 跨绳 vt.缚住或扎牢； 跨越时间或空间； 以掌测量； 以手围绕测量类似测量
physician	n. 内科医生
chamber	n. 房间,会所,室 vt. 装入室中(枪膛) adj. 室内演奏的
successfully	adv.顺利地,成功地
athlete	n. 运动员
motor	adj. 机动的,有引擎的，汽车的 n. 发动机,马达，汽车 vt. & vi. （用引擎）驱动
roughly	adv. 概略地,粗糙地,粗鲁地
diary	n. 日记,日记簿
consume	vt. 消耗，毁灭，吃，喝, 挥霍 vi. 耗尽生命, 被烧毁
shortly	adv. 立刻, 马上
attraction	n. 吸引, 吸引力, 有吸引力的人或事物
attribute	n. 属性, 特征; 标志, 象征 vt. 归于, 属于
ethnic	adj. 民族的，种族的，有民族特色的 n. 少数民族的一员
mud	n. 泥,泥浆,恶意诽谤和攻击 vt. 弄脏,污蔑
cheer	n. 愉快,激励,欢呼 vt. 加油,鼓舞,快活起来 vi. 使振奋,欢呼
automatic	n. 自动装置, 半自动武器 adj. 自动的,机械的,半自动化的
emission	n. 发射, 射出, 发行
spiritual	adj. 精神的, 心灵的 n. (尤指美国南部黑人的)圣歌
lab	n. 实验室
awful	adj. 可怕的, 畏惧的, 充满敬畏的, 艰难的 adv. 极其
sponsor	n. 保证人, 赞助者 v. 发起, 赞助
filter	n. 筛选,滤波器,过滤器,滤色镜 vt. &vi. 过滤,渗透 [计算机] 过滤
institutional	adj. 制度上的，惯例的，机构的
bang	n. 重击,突然巨响,刘海 vt. 重击,大声敲,剪成刘海 vi. 大声敲击,发出巨响 adv. 正好地, 准确地
lane	n. 小路, 小巷, 行车道
romantic	adj. 浪漫的 n. 浪漫的人
beneficial	adj. 有益的,有利的
bat	n. 蝙蝠,棒,击打,球拍 vt.& vi. 用棒击打 [计算机] DOS文件名: 批文件
civilization	n. 文明,文化
stair	n. 楼梯
neat	adj. 整洁的, 巧妙的, 端正的, 极好的, 纯的 adv. 整齐地
combat	n. 争斗,战斗 vt. 打斗 vi. 战斗,与…斗争 adj. 战斗的
necessity	n. 需要, 必需品, 必然
sanction	n. 核准,处罚,约束力 v. 制定制裁规则,认许,核准
classical	adj. 古典的, 典雅的, 经典的
classify	v. 分类,归类,分等
constitution	n.建立，组成； 体格； 构成方式； 宪法
exploration	n. 探险,踏勘,探测
tremendous	adj. 巨大的, 惊人的
reckon	vt. 计算,估计,认为 vi. 计(算),判断,依靠
trick	n. 诡计，欺诈，把戏，诀窍 vt. 戏弄,欺骗 adj. 有诡计的，有阴谋的
wheat	n. 小麦, 小麦色
portrait	n. 肖像,画像 adj. (文件页面)竖的
leak	n. 漏洞 v. 漏,泄漏 vi. 漏,渗
correspondence	n. 通信；一致；相当
bin	n. 箱柜 vt. 放入箱内 [计算机] DOS文件名: 二进制目标文件
sixty	n. 六十 adj. 六十的, 六十个的
processor	n. 加工者,处理器
lecture	vt. &vi. 讲课, 教导 n. 演讲, 教训, 斥责
coin	n. 硬币,金钱,货币 vt. 制造钱币,创造 adj. 与硬币有关的
eastern	adj. 东部的, 东方的
practically	adj. 实际地, 几乎 adv. 几乎, 简直, 实际上
stimulate	vt. 刺激,激励,鼓舞 vi. 起刺激作用
motive	adj. 发动的,运动的,积极的,动机的 n. 动机, 主题 vt. 促使, 使有动机
colony	n. 侨民,侨居地,殖民地,聚居(地)
elephant	n. 大象, 庞大笨拙难处理的事物
salt	n.盐； 风趣； 机智，讽刺； 药用盐，泻盐 vt.撒盐； 用盐渍； 加盐以调味； 为…增加趣味 adj.含盐的； 有咸味的； 盐渍的
extensive	adj. 广泛的,广阔的
charm	n. 魔力, 魅力, 护身符, 小饰物 vt. 吸引, 使...迷醉, 对...施以魔法
stranger	n. 陌生人
clarify	vt. 澄清,阐明,使...明晰
pretend	vt. &vi. 假装,伪称 adj. 假装的,赝品的,模拟的
uncle	n. 伯, 姑父, 舅, 叔, 姨父
lifetime	n. 一生, 终身，寿命，使用期限
oxygen	n. 氧,氧气
investigator	n. 调查者, 研究者, 审查者
panic	n. 恐慌,惊惶 adj. 惊慌的,没有理由的,恐慌的 vt. 使...惊慌
nowadays	adv. 现今,现在 n. 现今,当今
parish	n. 教区, 教区的全体居民, 地方行政区, (路易西安那州的)郡
scholar	n. 学者，获奖学金的学生
brick	adj. 砖似的 n. 砖 v. 用砖围砌,用砖填补 vt. (up)用砖砌,用砖堵住
communist	adj. 共产主义的 n. 共产主义者
tournament	n. 比赛,锦标赛,(中世纪的)骑士比武
limitation	n. 限制
patent	n. 专利权,执照,专利品 adj. 专利的,显著的,新奇的 v. 取得...的专利权,请准专利
favorable	adj. 有利的,赞许的,良好的,顺利的,偏袒的
anxiety	n. 焦虑,挂念,担心,渴望,热望
unite	v. 联合, 合并, 混合
universe	n. 宇宙
frequency	n.&amp;adj. 频繁,频率
participation	n. 参加, 参与
substitute	n. 代替者,代用品 v. 代替 vi. (for)代替 vt. 用...代替,代以
productive	adj. 能生产的；有生产价值的；多产的；有效率的
occasional	adj. 偶然的, 不时的
occupation	n. 职业
substance	n. 物质,实质,内容,重要性,财产
infection	n. 传染, 影响, 传染病
frustration	n. 打破,挫折,顿挫 [计算机] 失败
continuous	adj. 连续的, 继续的, 连绵不断的
virtual	adj. 虚拟的；有效的；实质上的，事实上的
sugar	n. 糖 vt. 使甜,使具有吸引力 vi. 形成糖状,变成颗粒状,造枫糖浆
duck	n. 鸭，鸭肉，板球零分 vt. 把…按入水中，低头弯身（以免被打中或看见)，躲避 vi. 迅速行进，飞快行走（以免被看见），推委责任
summarize	vt. &vi. 概述,摘要而言
celebrity	n. 名人, 著名,著名人士, 名声, 名誉, 社会名流
fur	n. 毛皮服饰,毛皮制品,毛皮
attendance	n. 出席,出席人数,出席率
superior	n. 上级,高手,上标 adj. 上层的,上好的,出众的,高傲的
elegant	adj. 优雅的, 精美的, 俊美的
confusion	n. 混乱,混淆,不确定状态
vacation	n. 假期, 休假，腾出 vi. 度假
bare	adj. 赤裸的,显露的,极少的,仅仅的 vt. 使赤裸,露出
bend	v. 弯曲, 屈服 n. 弯曲(物), 弯道
punch	n. 打洞器,钻孔机,殴打 n. 酒、水、糖等制成的鸡尾酒 vt. 以拳重击,开洞,剪票,按(键)
consequently	adv. 所以, 因此
bound	n. 跳跃,界限,范围 adj. 必定的，受约束的,装订的,有义务的 vt. 跳跃前进，形成界限
gentle	adj.温和的； 文雅的； 高尚的 vt.使温和； 使驯服 n.蛆； 饵
accurate	adj. 准确的, 精确的
venture	n. 冒险,风险,投机 vt. 敢尝试,谨慎地做，冒险一试 vi. 冒险做
gesture	n. 手势,姿态 vt.& vi. 作手势表达
historian	n. 历史学家，编史者
vertical	adj. 垂直的,顶点的,纵向的 n. 垂直物, 垂直的位置
vessel	n. 船,容器,脉管,血管,化身
embarrass	vt. 使...困窘,阻碍 vi. 变得困窘
prominent	adj. 杰出的,显著的,突出的
vice	n. 恶习,恶行,罪恶,缺陷,恶癖,老虎钳 vt. 钳住 prep. 代替,副,次
adapt	vt. 使适应,改编 vi. 适应，适合
profitable	adj. 有益的, 有用的
machinery	n. (总称)机器, 机械
charity	n. 慈善机关(团体),仁慈,宽厚
maker	n.制造者，制造商； [法] 签署本票的一方； 上帝； 〈古〉诗人
quantity	n. 量,数量,大量
barrel	n. 桶, 一桶的量, 大量, 枪管, 炮管, 笔管, 汽油桶 vi. 快速移动 vt. 把...装桶
enclose	vt. 围绕, 圈起, 放入封套, 附上 [计算机] 括入
convey	vt. 传达,运输,转移 [计算机] 输送
clinic	n. 诊所,门诊部,科室
visual	adj. 视觉的 n. 画面, 图象
provoke	vt. 激怒, 惹起, 驱使
sharply	adv. 锐利地, 严厉地, 厉害地
racial	adj. 种族的,人种的
comprehensive	adj. 综合的, 广泛的, 理解的
radiation	n. 辐射,放射线
intervention	n. 插入,介入,调停
confine	vt. 限制,闭居 n. 边界, 约束, 范围, 限制
cotton	n. 棉花,棉 vi. 向…讨好，明白，领悟
counter	n. 计算器,计算者,柜台 [计算机] 计数器 adj. 相反的 adv. 与…相反地 vt. 反对,反击 vi. 反对,反击
bubble	n. 泡沫, 气泡, 幻想, 骗局, 欢乐 vi. 起泡, 出现, 洋溢 vt. 使冒泡
entrance	n. 入口 v. 使出神,使入迷 vt. 使出神
envelope	n. 信封, 封皮,壳层
fiction	n. 小说,虚构
cousin	n. 堂(或表)兄弟(姐妹)
firstly	adv. 第一, 首先
infect	vt. 传染,感染
competitor	n. 竞争者,对手
complexity	n. 复杂，复杂性, 复杂的事物
cream	n.乳霜； 精英； 奶油色； 乳脂，奶油 vt.把…搅成糊状（或奶油状）混合物； 彻底打败，狠揍
mill	n. 磨粉机, 磨坊, 制造厂, 密尔:一种货币单位, 使陷于困境 vt. 磨细 vi. 乱转, 磨细
luxury	n. 奢侈, 豪华, 奢侈品
ridiculous	adj. 可笑的；荒谬的
amongst	prep. 在...之中,在...之间(=among)
injection	n. 注射,注射物,数学函数
butter	n. 黄油,阿谀奉承 vt. 涂黄油
poverty	n. 贫穷,贫困
silent	adj. 安静的,不吵闹的,沉默的,无言的 n. (复数)默剧
undoubtedly	adv.无庸置疑地,的确地
teenager	n. 13岁到19岁的年轻人
sin	n. 罪,罪孽,过失 vi. 犯罪,违反
induce	vt. 引诱,导致,催生
evolution	n. 进化, 发展, 进展
singer	n. 歌手,鸣禽 n. 烧毛工,烧毛机 Singer: 辛格(姓氏)
invention	n. 发明,发明物,虚构,虚构物
mate	n. 配偶, 同事, 助手 v. 使...配对, 交配, 使...一致, 结伴
designate	adj. 指定的 vt. 指定,选派,标明
inflation	n. 膨胀,通货膨胀
wherever	adv. 无论什么地方，在......的各个地方 conj. 无论在哪里
aggressive	adj. 侵略性的；好斗的；有进取心的；有闯劲的
tender	adj. 温和的, 亲切的, 未成熟的 vt. 提供, 投标
projection	n. 发射，计划，突出部分
interpret	v. 解释, 演出, 翻译 [计算机] 解释
regret	n. 遗憾, 后悔, 抱歉 v. 为...感到遗憾, 后悔, 惋惜
regularly	adv. 定期地,有规律地
slice	n. 薄的切片,一部份,锅铲 vt. 切成薄片,大幅降低
greet	vt. 问候,致敬,欢迎,映入眼帘
experimental	adj. 实验(性)的, 试验(性)的
melt	n. 熔化,熔化物 vt. &vi. 熔化,溶解, 软化, 渐渐混合
dawn	n. 破晓，开端 vi. 破晓,逐渐明白
gross	n. 总量 adj. 总共的, 粗鲁的, 严重的, 过胖的 vt. 总共赚得
extension	n. 延长,扩充,范围,分机号码
mess	n. 乱七八糟,一堆食物,集体用膳人员,大量 vt. &vi. 供给食物,把...弄乱
jacket	n. 短上衣, 茄克衫
darkness	n. 黑暗
render	vt. 使成为, 提供, 报答, 着色; 执行, 实施 vi. 给予补偿 n. 交纳, 粉刷, 打底
mild	adj. (烟、酒)味淡的,轻微的,温柔的,文雅的
assign	v. 分配,指派 n.[计算机] DOS 命令将驱动器符重指向第二个驱动器符
trainer	n. 训练者,驯服者,驯马师
registration	n. 登记,注册,挂号
stack	n. 堆叠,堆 vt. 堆积,成叠放在 vi. 堆成一堆
democratic	adj. 民主的, 大众的, 平等的
discrimination	n. 歧视, 辨别力, 识别
promotion	n. 促进,提升,推广
depress	vt. 使...沮丧,按,降低 [计算机] 降低
depth	n. 深度,强度,诚挚
surprisingly	adv. 惊人地(意外地)
uncertainty	n. 不确定, 不可靠, 半信半疑 (学术)不可信度; 偏差
cave	n. 山洞 v. (使)凹陷 vi. (in)塌落,倒坍
ceiling	n. 天花板,上限
interval	n. 间隔,休息时间, (数学)区间, (音乐)音程
monument	n. 纪念碑,历史遗迹
destruction	n. 破坏,毁灭,破坏者
ceremony	n. 典礼,仪式,礼节,礼仪
spectrum	n. 光谱, （比喻）范围, 系列
determination	n. (正式)决定,规定,决心,测定, 定位
spite	n. 恶意, 怨恨 vt. 刁难, 伤害
wander	vt. 闲逛走过 vi. 游荡,漫步,流浪,蜿蜒曲折,离群失散,走神 n. 游荡,闲逛,流浪,离群失散
diagram	n. 图解,图表 vt. 用图解法表示
mount	n. 山峰,乘用马,框,衬纸 vi. 增长,骑上(马) vt. 提升,爬上,装备
firmly	adv. 牢牢地
rhythm	n. 节奏,韵律
edit	vt. 编辑,编校,修订 n. 编辑工作
specify	vt. 明确说明,叙述,指定,详细说明
knee	n. 膝盖,像膝盖的东西,护膝,屈膝鞠躬 vt. 用膝盖顶
gaze	vi. 凝视 n. 凝视
knife	n. 刀 v. 用刀切割, 如刀割般
fiber	n. 纤维(物质),力量
expenditure	n. (时间、劳力、金钱等)支出,使用,消耗
musician	n. 音乐家，作曲家
dimension	n. 尺寸, 次元, 容积, 维度 n. 范围; 方面 vt. 标尺寸; 形成...尺寸
rival	n.对手； 竞争者 vt.与…竞争； 比得上某人 vi.竞争 adj.竞争的
laboratory	n. 实验室, 实验大楼
planet	n. 行星
mystery	n. 神秘,秘密,神秘的人或事物
dirty	adj. 肮脏的,色情的,卑鄙的 adv. 卑鄙地 vt. 使...变脏 vi. 弄脏
chocolate	n. 巧克力, 巧克力糖, 巧克力饮品 adj. 巧克力的, 有巧克力糖衣的, 巧克力色的
album	n. 集邮本,照相簿,唱片簿
alert	adj. 警觉的,灵敏的 n. 警戒,警报 vt. 警惕,使意识到
entrepreneur	n. 企业家
discharge	vt. &vi. 放出,解雇,放电,解除, 清偿债务 n. 释放，卸货，放电，一股，一阵，开火，发射，准许离开
bargain	n. 交易,买卖,物美价廉的东西 vi. 议价 vt. 议价交易
squeeze	n. 压榨,榨出的少量,佣金,经济拮据 vt. 紧握,挤压,使经济困难 vi. 让步,压迫,险胜
auction	n. 拍卖 vt. 拍卖
hesitate	vi. 犹豫, 停顿，口吃，迟疑，踌躇 vt. 用犹疑的态度表示
module	[计算机] 模块 n. 组件
transmission	n. 传输, 播送, 变速器, 传递的信息
distress	n. 苦恼, 贫困, 忧郁, 恶化, 扣押财物 vt. 使...苦恼, 仿造 adj. 亏本出售的
stain	n. 污染,污点,著色 v. 沾染,染污,著色
poet	n. 诗人
poetry	n. 诗歌
costume	n. 服装,剧装 vt. 提供服装, 为...设计服装 adj. 服装打扮的
philosophy	n. 哲学,哲理
snap	v. 猛咬, 谩骂, 砰然关上, 拍摄, 崩塌，劈啪作响 n. 啪嗒声, 快镜头，突然释放 adj. 匆忙的，突然的 adv. 劈啪作响地
treaty	n. 条约, 协定
royal	adj. 王室的,盛大的,极度的 n. 贵族,顶帆
architect	n. 建筑师
tobacco	n. 烟草
hopefully	adv. 怀着希望地, 但愿
disturb	vt. &vi. 扰乱,妨碍,使...不安
assert	vt. 主张,声明,断言
newly	adv. 崭新,新改,以新方法
testify	vt.& vi. 证明,作证,声明
fantastic	adj. 极好的,难以相信的,奇异的,幻想的
controversial	adj. 引起争论的,有争议的
cloth	n. 布料, 一块布
clothing	n. (总称)衣服
tube	n. 地铁,电子管,显像管,管,软管;电视
availability	n. 有效,有用,有益；可得到的人(或物)
coal	n. 煤, 木炭, 运煤工 vt. 烧成炭,供应煤 vi. 装煤, 加煤
wipe	n. 擦拭,用力打 vt. &vi. 擦,消除,拭去
clever	adj. 聪明的,机灵的
actress	n. 女演员
leisure	n. 闲暇；空闲；安逸 adj. 空闲的；有闲的；业余的
bush	n. 灌木(丛),荒野, 狐狸尾巴 vt. 用灌木保护或支撑, 加衬套于 vi. 成灌木形,丛生 adj. 长得低矮的，二流的
prayer	n. 祈祷, 祷告, 祷文
unexpected	adj. 想不到的, 意外的
trader	n. 商人，商船
manual	adj. 手工的,体力的 n. 手册,指南,键盘
revolutionary	adj. 革命的 n. 革命者
boost	n. 推进,支援,增加 vt. 推进,提高
beef	n. 牛肉 v. 抱怨, 诉苦
statistic	n. 统计数值
effectiveness	n.效力
forty	num.&amp;adj. 四十 pron. 四十(个,只...)
altogether	adv. 总共，完全
indicator	n. 指示器, 指示剂 [计算机] 指示符
zero	num.&amp;n. 零
fraction	n. 分数, 小部分, 破片
readily	adv. 不迟疑地,迅速地,轻易地
scope	n. 能力，范围，眼界，机会，余地 vt. 仔细研究
impress	n. 印象,特徵,印记 vt. 使...有印象,影响,印刻,传送 vi. 给人印象
probability	n. 可能性, 或然率, 机率
companion	n. 同伴, 同事, 成对物品之一, (船的)甲板间扶梯(或扶梯的顶篷) vt. &vi. 陪伴
subsequent	adj. 随后的,后来的
obstacle	n. 障碍,绊脚石
penalty	n. 处罚,惩罚
dealer	n. 经销商；商人；发牌者，庄家；[俚语]毒品贩子，贩毒者
approval	n. 批准, 认可, 同意, 赞同
dump	n. 垃圾场,堆放处 vt. 丢弃,抛售,导出 vi. 骤降,扔垃圾
friendship	n. 友谊, 友好
duration	n. 持续时间，期间
patch	n. 片,补丁,碎片 vt. 补缀,掩饰,平息
compound	n. 混合物,复合词 adj. 复(混)合的,合成的 vt. 混合,调合,妥协 vi. 混合,妥协
pronounce	vt.& vi. 发音,宣告,断言,发表意见
comprise	vt. 包含,构成
injure	v. 伤害, 使...受冤屈
listener	n. 听者, 听众
boast	n. 吹牛 vt. &vi. 吹牛,自夸
autumn	n. 秋季,秋天
psychological	adj. 心理(学)的
fulfill	vt. 履行,完成
trap	n. 圈套,陷阱,困境,双轮轻便马车 vt. &vi. 设圈套,设陷阱
probe	n. 探针,调查,探测器 vt. 用探针测,详细调查 vi. 详细调查
utility	n. 公共设施,效用,公用程序,实用品,实用 adj. 多效用的，多功能的
portray	v. 描写,描写...的肖像,逼真地描写
popularity	n. 普及,流行
dramatically	adv.戏剧地,引人注目地
valley	n. 山谷；流域；溪谷
potentially	adv. 潜在地
acceptance	n. 接受（礼物、邀请、建议等），同意，认可
consent	n. 同意, 许可 v. 同意, 承诺
unnecessary	adj. 不必要的,多余的 n. 不必要的东西
backward	adj. 向后的 adv. 向后
belt	n. 带(状物),腰带 vi. 飞奔,大声唱 vt. 系上腰带,环绕,击打,大声唱
prediction	n. 预言, 预报
electrical	adj. 电的,电气科学的
awareness	n. 认识(了解,知道)
dictionary	n. 词典, 字典, 辞典
consumption	n. 消费
kilometer	n. =kilometre 公里，千米(略作km)
lover	n. 爱好者, 情人
embrace	n. 拥抱 v. 拥抱,互相拥抱,包含
tail	n. 尾部, 后部, 侍从, 屁股, 硬币反面, 跟踪者 adj. 在后面的, 从后面而来的 vt. 连结, 除去尾巴, 装尾巴 vi. 附于其后, 尾随, 逐渐消失
hip	n. 臀部, 屋脊, 野蔷薇的果实, 时尚 vt. 告知 adj. 非常时尚的, 赞同的 interj. 表示满意或赞同的欢呼声
conversion	n. 转变, 改变信仰, 换位
maintenance	n. 维护, 保持, 维修, 生活费用 n. 供给, 抚养; 主张
bias	n. 偏见，斜纹 vt. 使偏心
corn	n. 谷物,谷粒,陈词滥调,鸡眼 vt. 使成颗粒状,用盐水腌制,用谷物喂 vi. 变成颗粒
hug	n. 紧抱,拥抱 vt. 紧抱,固执,挨着, 停靠 vi. 紧抱, 紧紧靠着
agriculture	n. 农业
recycle	vt. 使再循环,再利用,再制 vi. 循环 n. 再循环
gut	n. (复)胆量, 魄力, 肠, 肠线 vt. 取出内脏, 毁坏(建筑物, 房间等)的内部 adj. 本能的, 利害攸关的
identification	n. 身份的证明 n. 视为同一,证明同一,确认
motivation	n. 动机
shortage	n. 不足,缺少
equation	n. 相等,方程(式),等式,均衡
realistic	adj. 现实的, 现实主义的
rat	n. 鼠,卑鄙的人,变节者 vi. 背叛,捕鼠 vt. 弄蓬松,告发
inventory	n. 详细目录, 存货(清单) vt. 编制(详细目录)
shower	n. 阵雨,淋浴 vi. 倾盆而下,淋浴 vt. 淋湿,下骤雨,使(大量东西)落在某人身上
burst	n. 破裂,阵,爆发 vt.&vi. 爆裂,突发
bury	vt.埋葬，葬； 为…举行葬礼； 隐藏，埋藏，遮盖，掩蔽； 专心致志于，埋头于，沉溺于
establishment	n. 确立,制定,设施,机构,权威
wealth	n. 财产,财富,大量,丰富
march	n. (March)三月 n. 示威游行 vt. 使前进,使行军 vi. 行军,进军
outer	adj. 外部的, 外面的
mislead	vt. 误导，使产生错误印象，欺骗，使误入歧途
criticize	vt. 批评, 吹毛求疵, 非难 vi. 批评
seminar	n. (大学的)研究班,研讨会
insert	n. 插入物 vt. &vi. 插入
rope	n. 绳，绳索 vt. 捆，绑 vi. 拧成绳状
naked	adj. 裸体的,无掩饰的,明白的,手无寸铁的
golden	adj. 金(黄)色的
evolve	vt. &vi. 进展,进化,展开
thread	n. 线,纤维,思路,线索, 螺纹 vt. 穿线于,穿过,成线, 遍布 vi. 小心地通过, 蜿蜒前进, 滴下成丝状
apologize	v. 道歉 vi. 道歉,谢罪 vt. 道歉,谢罪,辩白
administrative	adj. 行政的,管理的
temple	n. 庙宇,寺院 n.太阳穴
ingredient	n. 成分, 因素
sixteen	num. 十六 pron.&amp;adj. 十六(个,只...)
curve	n. 曲线,弯曲,曲球 vt. 使...弯曲 vi.弯曲
mayor	n. 市长
exclusively	adv. 排他地(独占地,专门地,仅仅,只)
execute	vt. 执行,处决，实行,完成 [计算机] 执行
whisper	vt.低声说； 私语； 密谈，密谋坏事； 私下说 vi.沙沙地响； 耳语； 密谈 n.低语，耳语； 飒飒声； [医]嗫音； 传闻
palace	n. 宫殿 adj. 宫殿的,殿堂级的
pale	n. 尖木桩,栅栏,界限 adj. 苍白的,暗淡的,弱的,浅色的 vi. 变得苍白,变得暗淡 vt. 使苍白
grasp	n. 把握,抓紧,领会 vt. 抓住,紧握,领会
puzzle	n. 难题,迷惑 vt. 使困惑,解决 vi. 迷惑,苦思
chat	n. 聊天,闲谈 vt. &vi. 谈天,闲谈
sculpture	n. 雕塑 vt. 雕刻,雕塑 vi. 当雕刻师
interact	vi. 相互作用,相互影响
boot	n. 靴子,[英]汽车行李箱,猛踢, 锁扣 vt. 踢, 穿靴子,锁车 vi. 启动（计算机),在（通常为非法停放的汽车）车轮上装制动装置, 利用, 帮助
campus	n. (大学)校园
explode	vt. 爆炸,驳倒 vi. 爆炸,爆发(感情)，激增 [计算机] 爆炸
reliability	n. 可靠性
relieve	vt. 减轻,救济,解除
incredibly	adv. 难以置信地, 不可思议地
passion	n. 激情,热情
tune	n. 旋律,音准,数量 vt. 调音(频),调节,使和谐 vi. 和谐,调频
fabric	n. 织物, 布, 结构
server	n. 服伺者,服勤者,伺候者
strain	n. 张力；拉紧；负担；扭伤；血缘 vi. 拉紧；尽力 vt. 拉紧；滥用；滤去；竭力
portfolio	n. 文件夹，作品集，证券投资组合
faculty	n.能力，才能； 全体教职员； <英>（大学的）专科，系； 特权，特许
carpet	n. 地毯,毛毯 vt. 铺以地毯,铺盖
wooden	adj. 木制的，生硬笨拙的
solar	adj. 太阳的,太阳能的
sole	adj. 唯一的, 独占的 n. 脚底, 鞋底; sole 或soles 鳎鱼 vt. 给(鞋)换底
jury	n. [法] 陪审团；评判委员会 adj. 应急的
meaningful	adj. 意义深长的,有意义的
discourse	n. 谈话,演讲 vi. 谈话,讲述 vt. 叙述,讨论
resist	v. 抵抗, 耐得住, 压制 n. 保护膜
mixture	n. 混合, 混合物
keen	adj. 锋利的,敏锐的,强烈的,精明的,热衷于
harm	n. 伤害 vt. 伤害
modify	vt. 修改,调正,缓和 vi. 修改
harsh	adj. 粗糙的, 使人不舒服的，刺耳的, 严厉的，大约的
permission	n. 同意,许可,允许
nut	n. 坚果,螺母, 螺帽,难对付的人(事) vi. 采坚果
fate	n. 命运,天意 vt. 注定
tissue	n. (动、植物的)组织,薄的纱织品，餐巾纸,手巾纸
pregnancy	n. 怀孕
moon	n. 月亮
resume	v. 再继续, 重新开始 n. 简历, 履历; 摘要
adjustment	n. 调整
rough	adj.粗糙的，崎岖不平的； 粗鲁的； 狂暴的，汹涌的； 未经加工的 vt.粗暴地对待； 使粗糙； 草拟 n.粗糙的部分； 艰难，苦难； （高尔夫球场的）深草区 adv.粗暴地 vi.举止粗野
revise	n. 校订, 修正, 再校稿 v. 校订, 修正, 校正
allege	vt. 断言,宣称
dialog	n. 对话, 对白 （美）=dialogue
feedback	n. 反馈,成果
diagnosis	n. 诊断
tongue	n. 舌头,语言,口条,语言,说话方式 vt. 舔,闲谈,斥责 vi. 吹乐器
separation	n. 分离, 分居, 缺口
pile	n. 堆,桩,大量,核反应堆 vi. 形成堆,拥挤进入 vt. 堆积,装载
cheese	n.奶酪； <俚>微笑 vt.<俚>停止
pipe	n. 管,烟斗,笛 vt. 以管输送,装管道,吹奏,尖声说,拷边 vi. 吹奏管乐,尖叫
needle	n. 针 vt. 用针缝,激怒,嘲弄 vi. 缝纫
await	vt. 等候,准备...以待,储存 vi. 等待
eighty	num.&amp;adj. 八十 pron. 八十(个,只...)
flexibility	n. 灵活性, 柔韧性，适应性
boom	n. 繁荣,低沉声,帆杠,水栅 vi. 发出低沉声,急速增长 vt. 回响,急速增加,有力地击打
subsequently	adv. 后来, 随后
spray	n. 水沫,喷雾器 vt. &vi. 喷雾,扫射,喷射
disagree	v. 不一致, 有分歧，不适应，不适宜
dedicate	vt. 献出,提献辞,致力于
distant	adj. 遥远的,疏远的，远房的，陌生的，远行的
transformation	n. 转型,转化,改造
survival	n. 生存,幸存者
translation	n. 翻译, 译文
burden	n. 负担, 重载 v. 使负重, 装载, 烦扰
dislike	v. 不喜欢,厌恶 vt.&amp;n. 不喜爱,厌恶
execution	n. 实行,完成,执行
diverse	adj. 不同的,相异的,多种多样的
neglect	n. 疏忽,忽略,怠慢 vt. 疏忽,忽视,不顾
flash	n. 闪光,闪现,闪烁物,花哨,一瞬间,电脑动画技术 vi. 闪现,闪烁 vt. 传送,用光联络,流露出 adj. 花哨的,炫耀的,昙花一现的
extract	n. 榨出物,精华,摘录 vt. 拔出,榨出,摘录,提取,选取 [计算机] 提取
nerve	n. 神经(生物)，精神,勇气,叶脉 vt. 鼓起勇气
facilitate	vt. 帮助, 使...容易, 促进
tropical	adj. 热带的, 炎热的, 热带植物的
vegetable	n. 蔬菜；植物人；生活单调乏味的人 adj. 植物(性)的；得自植物的；关于植物的；蔬菜的
portion	n. 部分,份,命运 v. 将...分配,分配
absent	adj. 缺席的,缺少的 vt. 使缺席
acceptable	adj. 合意的, 受欢迎的, 可接受的
fold	vt. 折叠；合拢；抱住；笼罩 n. 折痕；信徒；羊栏 vi. 折叠起来；彻底失败
deadline	n. (鉴于边上的)警戒线,最后期限,截止时间
pot	n. 罐,壶,一大笔(钱) vt. 把...装罐,(台球)入袋
potato	n. 马铃薯, 土豆
ton	n. 吨
lend	vt. 借,贷款,给予,增添 vi. 贷款
praise	n. 赞美,称赞,崇拜 vt. 称赞,归荣誉于,赞美 vi. 赞美
pray	vt. &vi. 祈祷, 恳求
transmit	vt. 传输, 传送, 代代相传, 传达 vi. (以无线电或有线电的方式)发送信号
stomach	n. 胃 v. 忍受,容忍 vt. 承受,忍受
comic	n. 连环图画,喜剧演员,喜剧元素 adj. 滑稽的,有趣的,喜剧的
hungry	adj. 饥饿的，渴望的
storage	n. 储存体, 储藏, 仓库, 保管费
transition	n. 过渡,转变
physically	adv. 身体上地
forever	adv. 永远 n. 漫长时间
audit	n. 查帐,审计 vt. 审计,旁听
alcohol	n. 酒精，酒, 醇
formation	n. 构造,编队,形成
strengthen	vt. &vi. 加强,变坚固
fortune	n. 财产,命运,运气
foster	adj. 收养的,养育的 v. 养育,抚育,培养 n. (Foster)人名；(英、捷、意、葡、法、德、俄、西)福斯特
undergo	vt. 遭受,经历,忍受
printer	n. 打印机，印刷工
rice	n. 稻,饭,米
angle	n. 角(度),角落 vt. 斜移,转变角度 vi. 钓鱼,谋取,转变角度 n. (Angle)盎格鲁人
shareholder	n. 股东，股票持有人
unfortunate	adj. 不幸的, 令人遗憾的，不成功的 n.不幸的人
commonly	adv. 一般地,通常地，普通地
objection	n. 反对,异议
freely	adv. 自由地，免费地, 直率地, 大量地
seal	n. 印章, 封条, 海豹 v. 盖印, 封闭, 猎海豹
observer	n. 观察者
profession	n. 职业,专业,声明,信仰
bite	n. 咬,一口,少量食物,咬伤的伤口 vt. 咬,刺穿(痛) vi. 咬(饵),使剧痛,紧抓
riot	v.&amp;n. 骚乱,闹事 vi. 闹事,骚乱
sperm	n. 精液, 精子 n. 与抹香鲸有关的物质(如鲸脑油) pref. 表示“精液，精子，种子”（=spermo-,sperma-，spermi-）
horizon	n. 地平线；视野；眼界
compute	vt. 计算
consultation	n. n. 请教,咨询,协议会
dot	n. 小圆点,少量,小东西 vt. 作小点记号,点缀 vi. 作小点记号 [计算机] 点
withdrawal	n. 撤退,退回,取消
usage	n. 惯用法,使用,用法
province	n. 省, 范围
genetic	adj. 基因的, 遗传的, 起源的
confident	adj. 确信的, 自信的
isolation	n. 隔离, 孤立
absolute	adj. 绝对的,完全的,无限制的,独立的,专制的 n. 绝对的事物
surgery	n. 外科,外科手术, 诊所
sensible	adj. 可察觉的,意识到的,实用的 n. 可感知物
whale	n. 鲸,大量 vi. 捕鲸 vt. 鞭打,打击,打败
pose	n. 姿势,姿态,装模作样 vt. 提出(问题),引起,定格 vi. 摆姿势,装模作样
celebration	n. 典礼,宗教仪式,庆祝
sustain	vt. 承受, 支持, 经受, 维持
bow	n. 弓,船头,鞠躬，蝴蝶结，两手准备 vi. 鞠躬, 成弓形，弯腰, 首次上演，屈服，听从，尊重 vt. 重压，弯曲，
swear	n. 发誓, 誓言 vt. &vi. 发誓, 宣誓, 咒骂
automatically	adj. 不经思索的 adv. 自动地
characterize	vt. 表示...的典型,赋予...特色
bread	n. 面包,食物,生计 vt. 撒面包屑
flood	n. 洪水,水灾 v. 淹没,溢出 vi. 大量涌到,泛滥 vt. 灌溉,淹没
veteran	adj. 老练的 n. 老兵, 老手
continent	n. 大陆, 洲, (the Continent)欧洲大陆
loyalty	n. 忠诚, 忠心
youngster	n. 年青人, 少年，小伙子，儿童，幼小动物
seventeen	num. 十七
adequate	adj. 足够的, 充足的, 适当的, 能胜任的
adjust	vt. 调整, 使...适于 vi. 适应
bulk	n. 大部分, 大多数, 大块, 大批, 容积, 体积 vi. 变大, 增加 vt. 膨胀, 出现 adj. 大量的
visible	adj. 可见的, 看得见的
psychology	n. 心理学
institute	n. 学会,学院,协会 vt. 创立,开始,制定
weird	adj. 怪异的，离奇的 n.命运；预言者
enforce	vt. 加强, 强迫, 执行
shed	n. 车棚,小屋,脱落物 vt. 使...流出,散发,脱落,除掉
depict	vt. 描述,描绘
shine	n. 光泽, 阳光, 光辉, 喜欢 vt. 使发光, 照射在...上, 擦亮 vi. 发光, 表现出众, 闪耀着
incline	n. 倾斜, 斜坡, 斜面 v. 使...倾向, 爱好, 易于
cottage	n. 村舍, 小屋，小别墅
discovery	n. 发现, 发现物
airplane	n. 飞机 =aeroplane(英）
alarm	n. 警报,惊慌,警告,报警器 vt. 使...惊慌,警告, 装报警器
glance	vi.一瞥； 闪微光； 掠过，擦过； 随便提到，简略地触及 n.浏览； 闪光； 歪斜，一掠
quietly	adj. 寂静地, 静止地 adv. 安静地, 平静地
championship	n. 锦标赛,冠军，拥护
shore	n. 岸,滨,国家,陆地,斜撑柱 vt. (up)支撑,支持
entity	n. 存在,实体
comparable	adj. 可比较的, 比得上的
rapid	adj. 迅速的,急促的 n. 急流
throat	n. 喉咙,嗓音 vt. 低语,压着嗓子说(唱)
craft	n. 工艺, 手艺, 狡诈，航空器, 行会成员 vt. 手工制作
crazy	adj. 疯狂的，荒唐的 n. 荒唐的人 adv. 疯狂地
influential	adj. 有权势的,有影响的 n. 有影响力的人物
creative	adj. 创造性的
precisely	adv. 精确地
curious	adj. 好奇的,古怪的
pole	n. 极(点),杆子 vt. 跳,支撑 vi. 用篙撑船
innocent	adj. 无罪的, 不懂事的, 无知的, 无辜的
involvement	n. 包含, 缠绕, 混乱, 复杂的情况
rear	n. 后面,背后,臀部 adj. 后面的,背面的,后方的 vt. 养育,饲养,举起,建立 vi. 高耸,用后腿站立
narrative	n. 叙述,故事 adj. 叙述的,叙事的,故事体的
evident	adj. 明显的, 明白的
overlook	v. 俯看, 远眺, 没注意到
exact	adj. 精确的 vt. 强求,要求,索取
govern	vt. 统治,支配,管理,规定 vi. 统治,执行
cure	n. 治疗,治愈,治疗法 vt. &vi. 治疗,治愈,改正
exceed	vt. 超过, 胜过, 超出界限 vi. 领先
stance	n. 立场；姿态；位置；准备击球姿势
ownership	n. 所有权
intelligent	adj. 聪明的, 智能的
intense	adj. 非常的,强烈的,紧张的,热情的
custom	n. 习惯, 风俗, 海关
grain	n. 谷物, 谷类, 颗粒, 细粒, 纹理 vt. 用谷物喂养, 形成颗粒
tent	n. 帐篷 vt.& vi. 住帐篷,宿营
painter	n. 画家
guitar	n. 吉他 vi. 弹吉他
cake	n. 蛋糕, 薄饼, 块状物, 小菜一碟(容易做成的事) vt. 涂厚厚的一层, 覆盖, 填满 vi. 结成块
skirt	n.裙子； 边缘； （连衣裙、外衣等的）下摆； （车辆或机器基座的）挡板 vt.& vi.位于…的边缘； 沿…的边缘走； 绕开； 避开,避开
exhaust	n. 排气,排气装置 v. 用尽,耗尽,使...精疲力尽 [计算机] 排除
mad	adj.发疯的,狂热的,着迷的,生气的 vt.& vi. 发怒 n. 发怒
slave	n. 奴隶, 完全受控制的人, 劳工, 从动装置 vt. 对另一种装置作出直接回应 vi. 拼命工作, 贩卖奴隶
grave	adj.重大的，重要的； 严重的； [音乐]沉重的； （颜色等）朴素的 adv.沉重地，庄重地； 极慢地 n.坟墓，墓穴； 埋葬…的地方； 下场； 死亡 vt.雕刻； 铭记
undermine	vt. 暗中损害, 逐渐削弱, 在(某物)下挖洞或挖通道, 从根基处损害
paragraph	n. 段落 vt. 将...分段,写短评 vi. 写短评
greatly	adv. 很, 非常
reinforce	vt. 加强，加固；强化；补充 vi. 求援；得到增援；给予更多的支持 n. 加强；加固物；加固材料
partial	adj. 部分的,偏袒的,偏爱的 n. 泛音
corridor	n. 走廊
stimulus	n. 刺激, 激励, 刺激品
exploit	n. 功绩,勋绩 vt.&vi. 开发,利用,开拓
virus	n. 病毒, 毒素, 有害的事物
explosion	n. 爆炸,爆发,激增
steadily	adv.稳定地,有规则地
wisdom	n. 智慧,学问
sheer	adj. 绝对的,全然的,峻峭的 vt. &vi. 急转,躲避 adv. 完全,全然,峻峭 n. 转向,(甲板的)脊弧,透明薄织物
guidance	n. 引导,指导,导航系统
remarkable	adj. 显著的, 异常的, 非凡的, 值得注意的
substantially	adv. 实质上,本质上,大体上
accessible	adj. 可得到的, 易接近的, 可进入的
strategic	adj. 战略的,重要的,基本的
jazz	n. 爵士乐，爵士舞，空扯的话，以及类似的东西 vt. 使...活泼，把...演奏成爵士风格 vi. 闲逛，跳爵士舞
notably	adv. 显著地(著名地,值得注意地,格外,特别是)
cough	n. 咳嗽 vt. &vi. 咳嗽
assignment	n. 分配,功课,任务,被指定的(课外)作业;(分派的)任务, 委派
differently	adv. 不同地
mineral	adj. 矿物的 n. 矿物, 矿石
amendment	n. 改善(正),修正案,某物质能改善土壤有助生长
carve	vt.& vi. 雕刻,切割
ugly	adj. 丑陋的, 难看的
elaborate	adj. 精细的, 详尽的, 精心的 v. 详细地说明, 用心地作, 推敲
density	n. 密集,密度,透明度
fame	n. 名声,名望 vt. 使有名望
liability	n. 责任, 可能性，债务, 不利因素
resign	vi. 辞职,顺从 vt. 辞职,放弃,使顺从
sometime	adj. 以前的, 某一时间 adv. 改天, 来日
strand	n.（绳子的）股，绞； 海滨，河岸； （思想等的）一个组成部分 vt.使滞留，使搁浅； 使陷于困境 vi.搁浅； 陷入困境
detect	vt. 发现,探测信息,侦查 vi. 当侦探
slot	n. 水沟,细长的孔,狭缝,职位, 插槽, (鹿的)踪迹 vt. 留细长的孔,插入, 放置 vi. 适用于
adolescent	adj. 青春期的, 青少年的 n. 青少年
politically	adv. 政治上地
reverse	n. 相反; 背面; 失败, 挫折 adj. 反面的, 相反的, 颠倒的 v. 颠倒, 逆转, 倒退
enforcement	n. 厉行, 执行, 强制
illegal	adj. 不合法的,非法的 n. 非法移民
cluster	n. 串,丛,群 v. 聚合,成串,丛生,使...聚集
ongoing	adj. 前进的,进行的 n. 前进,举止,行为
distinct	adj. (from)独特的,不同的,明显的,清楚的
cheek	n.脸颊，脸蛋； 无礼而放肆的行为，厚颜； 半边屁股； 两侧相对的物体 vt.对…无礼地说话
float	n. 漂流物,装有轮子的展台或平板车,企业的日常零钱 vt. 使漂浮,提出,开办新公司,洽谈 vi. 漂浮,游荡,飘
membership	n. 成员资格,会员全体，从属关系
pioneer	n. 先锋,拓荒者,先驱生物 vt. 提倡,开辟 vi. 做先驱
interface	n. 界面,接触面 vt. 连接,作接口 vi. 连接
digital	adj. 手指的,数字的,数码的,电子的
pit	n. 深坑,核,矿井,陷阱,英国剧场正厅后排, 凹陷疤痕 vt. 使...有伤痕,去...的核,与...较量
insight	n. 洞察力
sufficiently	adv.十分地,充分地
advocate	vt.提倡； 拥护； 鼓吹； 为…辩护 n.（辩护）律师； 提倡者； 支持者
bonus	n. 红利, 奖金
engagement	n. 诺言, 约会, 婚约, 交战, 雇用, (机器零件等)啮合
subtle	adj. 微妙的,敏感的,精细的,狡诈的,不明显的
platform	n. 平台,月台,讲台,坛,计划
robot	n. 机器人
suicide	n.自杀； 自杀者； 自杀行为 vt.自杀 adj.自杀的
lamp	n. 灯, 发光或反射光的天体, 灵光
alongside	adv. 在旁边 prep. 在...旁边
headquarter	vt. 总部设于 vi. 作为总部 n. (headquarters)总部,总局
barrier	n. 界线,屏障,障碍物 v. 以屏障隔开
essence	n. 本质,精髓,要素,香精
shadow	n. 阴影, 阴暗, 预兆, 跟踪盯梢的人 vt. 跟踪, 笼罩 vi. 投阴影于..., 使...忧沉,预示 adj. 影子内阁的, 阴暗的
swallow	n. 燕子, 吞咽, 一次吞咽的量 vt. 吞下, 咽下, 忍受, 不流露感情, 收回 vi. 咽口水, 忍气吞声
slope	n. 倾斜,斜坡,斜面,斜线 vt. 使倾斜 vi. 倾斜,有坡度
hint	n. 暗示,提示,小部分 vt. &vi. 暗示,示意
thirteen	num. 十三
implementation	n.执行
supplement	n. 补充物,增刊 vt. 补充,增补
survivor	n. 幸存者
trail	n. 踪迹,小径,尾 vi. 拖,尾随,追踪,落后于 vt. 拖拽,追踪
tribe	n. 部落,种族,一伙人
flesh	n. 肉(体),人性 vt. 用肉喂,赋予血肉,使长肉 vi. 变胖
league	n. 联盟,社团
cooperation	n. 合作, 协作
regardless	adj. 不注意的, 粗心的 adv. 不顾
leap	n. 跳跃,剧增,急变 v. 跳跃,跃过,猛冲 adj. 闰年的
possession	n. 财产, 所有, 拥有
steep	adj. 险峻的, 陡峭的, (价格)过高的 vt. &vi. 浸泡,浸透, 使精通 n. 陡坡, 险峻的境地
stem	n. 茎,干,船首,词干,血统 vt. 堵住,阻止,抽去梗 vi. 起源于,发生
composer	n.创作者（尤指乐曲的）
motivate	v. 给与动机,刺激,提高...的学习欲望
ethics	n.偶尔,道德规范
admire	vt. 钦佩, 羡慕, 赞美
collective	adj. 集体的,共同的 n. 集体
fantasy	n. 幻想 v. 幻想
flee	vi. 逃跑, 逃走, 消失 vt. 避免, 回避
pro	n. 能手(赞成) adv. 正面地
prejudice	n. 偏见,成见,伤害 v. 使...存偏见,使...有成见,伤害
sand	n. 砂, 沙滩 v. 撒沙, 以沙掩盖
drain	n. 下水道,排水沟,消耗 vt. 耗尽,排出,排干,喝光 vi. 变干,排出,排水
forecast	n. 预测,预报 vt. &vi. 预测
precede	vt. &vi. 在...之前,优于,较...优先
liberty	n. 自由；许可；冒失
par	n. 标准, 票面价值, 平均数量 adj. 票面的, 平常的, 标准的
donor	n. 捐赠人 [计算机] 施主
formerly	adv. 以前, 从前
prevail	vi. 获胜, 盛行, 主导
uncomfortable	adj. 不舒服的, 不自在的
scan	vt. 扫描；浏览；细看；详细调查；标出格律 vi. 扫描；扫掠 n. 扫描；浏览；审视；细看
unemployed	adj. 失业的，未投资的 n. 失业者
illustration	n. 插图,例证,说明,图解
scholarship	n. 奖学金, 学问, 学识
imagination	n. 想象,想象力,空想
drill	n. 训练；钻孔机；钻子；播种机 vi. 钻孔；训练 vt. 钻孔；训练；条播 n. (Drill)人名；(德、英)德里尔
innovative	adj. 革新的, 创新的
nowhere	adv. 任何地方都不 n. 不知道的地方, 无处
immigrant	n. 移民, 侨民 adj. 移民的
evaluation	n. 估价,评价
rape	n. 抢夺,掠夺,强奸 vt. 掠夺,抢夺,强奸
expertise	n. 专家的意见,专门技术
convict	n. 囚犯,罪犯v. 使...确信自己犯错,宣告...有罪,使...知罪
hook	n. 钩子,钩拳 vt. &vi.钩住
economist	n. 经济学家 &lt;古&gt;节俭的人
medieval	adj. 中世纪的
literary	adj. 文学的
counterpart	n. 职位（或作用）相当的人；对应的事物
progressive	adj. 前进的, 渐进的 n. 进步人士
breakdown	n. 崩溃,故障,分类,腐烂,失败,一种街舞
suck	v. 啜,吸,吸入,吮吸 &lt;俚&gt;糟糕, 太烂了
compose	vt. 组成, 写作, 作曲, 使镇静 vi. 创作
eager	adj. 渴望的, 热切的
bless	vt. 赐福,祈佑,称颂上帝,使神圣,赋予
blind	adj. 盲目的,瞎的,未察觉的 n. 百叶窗,幌子 vt. 使失明,隐藏 adv. 盲目地
seize	vt. 抓住,攻占,理解,侵袭 vi. 抓住,卡住,终止
harbor	n. 海港,避难所 vt. 庇护,心怀,窝藏 vi. 进入避祸所,生存
outstanding	adj. 突出的, 显著的, 未支付的
contrary	adj. 相反的,截然不同的 adv. 相反(地) n. 反面,相反
shelf	n. 架子,搁板(状物),岩棚
nest	n. 巢, 窝 vt. 嵌入 vi. 筑巢
dull	adj. 呆滞的,迟钝的,无趣的,钝的,暗的 vt. 使变钝 vi. 变钝
festival	adj. 节日的,喜庆的,快乐的 n. 节日,庆祝及祭祀,欢宴
horrible	adj. 可怕的,令人毛骨悚然的,令人讨厌的
repeatedly	adv. 重复地, 再三地
eighteen	num. 十八
van	n. 货车,先驱 vt. 用货车运
suspend	v. 推迟,悬(浮),挂,暂停,取消 vi. 吊,悬浮 vt. 悬,挂,吊,暂停,中止
accomplish	vt. 完成
accordingly	adv. 因此,于是,如前所说 照着 相应地
halt	n. 停止，中止; 暂停; 小火车站 vt. 使停止; 使中断; 阻止; 使立定 vi. 停止，立定; 犹豫
presumably	adv. 推测上,假定上,大概
consult	v. 商讨,向...请教,查阅
eleven	num. 十一 pron.&amp;adj. 十一(个,只...)
acre	n. 英亩
god	n. 神,偶像,(God)上帝 vt. 像对神一样崇拜
contest	n. 竞赛,比赛 vt. 竞赛,争取 vi. 奋斗
organizational	adj. 组织的
corruption	n. 腐败, 堕落, 贪污
lung	n. 肺,呼吸器官
empire	n. 帝国
photographer	n. 摄影师
breed	n. 品种,族类 vt. 养育,繁殖,引起 vi. 繁殖
violent	adj. 暴力的,猛烈的,极端的,曲解的
brilliant	adj. 灿烂的,有才气的,杰出的
opponent	n. 对手, 敌手, 反对者 adj. 敌对的, 反对的
universal	adj. 普遍的,通用的,宇宙的 n. 通用
endure	vt. 忍耐,容忍 vi. 持久,持续
rabbit	n. 兔子 vi. 猎兔 vt. 让...见鬼去吧,该死
announcement	n. 公告,发表,告知
abortion	n. 流产,堕胎
organic	adj. 器官的,有机的,根本的,接近自然的 n. 有机物质
hypothesis	n. 假设, 猜测, 前提
entertain	vt. &vi. 娱乐,招待,怀抱
random	n. 随意,任意 adj. 任意的,随便的,胡乱的 adv. 随机地
endorse	vt. 背书；认可；签署；赞同；在背面签名
bullet	n. 子弹
bunch	n. 一串,一束,一组,凸起,大量 vi. 凸起,使成一束(或一群等) vt. 使成一束
bundle	n. 捆,束,一批,一大笔钱 vt. 捆,匆匆送走,附赠 vi. 匆忙
ambition	n. 雄心,野心,抱负,精力 vt. 有...野心,追求
weakness	n. 软弱
refugee	n. 难民, 流亡者
sigh	n. 呼吸，叹息（带有情感） vi. 发出叹息的声音，感叹 vt. 叹息
outlet	n. 出口, 出路, 通风口, 批发商店
inquiry	n. 打听, 询问, 调查, 查问 =enquiry(英)
constitute	vt. 构成,建立,任命
cruise	n. 巡航,巡弋,漫游 vi. 乘船游览,慢速行驶,巡行,猎艳 vt. 巡游,猎艳
controversy	n. (公开的)争论,争议
mask	n. 口罩, 假面具,掩饰, 面膜 vt. &vi. 戴面具,掩饰,化装 [计算机] 掩码
overcome	vt. 战胜,克服,(感情等)压倒, 使受不了 vi. 获胜, 赢
sheep	n. 羊, 绵羊
recovery	n. 恢复,复原,痊愈
grace	n. 优雅,魅力,恩惠,慈悲 vt. 使荣耀,装饰
tempt	vt. 诱惑；引起；冒…的风险；使感兴趣
apple	n. 苹果
stir	n. 感动(激动,愤怒或震动), 搅拌, 骚乱 vt. 激起,惹起,搅和 vi. 挪动, 活动, 离开, 搅拌, 激动
tense	adj. 紧张的, 拉紧的 vt. 使紧张, 拉紧 vi. 变得紧张 n. (动词的)时态
interfere	vi. 妨碍,冲突,干涉
calculation	n. 计算
measurement	n. 测量,衡量,尺寸,大小
whoever	adv. 无论是谁,任何人 pron. 究竟是谁,谁,无论谁,不管谁
grass	n. 草 vt. 以牧草喂养,覆盖着草
damn	vt. 谴责，该死 vi. 诅咒,下地狱 n. 诅咒 adj. 该死的，可恶的 adv. 非常
pant	n.喘气，喘息； 气喘； 喷气声 vi.喘气，喘息； 喘着气说，气喘吁吁地讲； 热望，渴望，想； （机车等）喷气 vt.气喘
parallel	adj. 平行的,相同的,类似的,并联的 adv. 平行地 n. 平行线(面),相似物,对比 vt. 相比,相应,与...平行
artistic	adj. 艺术的
invent	v. 发明 vt. 发明,创造
intervene	vi. 插入,介入,干涉,调停 [计算机] 介入
strictly	adv. 严格地
defensive	adj. 防卫的, 防备用的, 辩护的 n. 守势, 防卫姿势, 防卫物
barely	adv. 少量地,几乎不地,勉强
invitation	n. 邀请
menu	n. 菜单
merchant	n. 商人,店主,专家 adj. 商业的
mere	adj. 纯粹的,仅仅的,只不过的 adv. 仅仅,只不过 n. 小湖
cap	n. 帽子,盖子,顶 vt. 给戴帽,覆盖顶端,超过,形成化学键于,抑制 vi. 形成化学键
remote	adj. 偏僻的,遥远的,远程的，(感情等)距离很大 n. 远程操作
carbon	n. 碳,灯芯,复写纸
jet	n. 喷气式飞机，喷射,喷出,黑玉大理石 vt. 射出，喷射 vi. 气流中喷出 adj. 煤黑色的
therapy	n. 疗法,治疗
curtain	n. 窗帘,遮蔽物,幕 vt. 用窗帘装饰,遮蔽
designer	n. 设计者
simultaneously	adv. 同时地
identical	adj. 相同的,同一的
questionnaire	n. 调查表
graph	n. 图表,曲线图 v. 图表,用图表表示 vt. 以(曲线)图表示
biological	adj. 生物学的
joy	n. 欢乐,喜悦,乐趣,乐事 v. 欢乐,高兴,乐趣
incentive	adj. 刺激的, 鼓励的 n. 刺激, 鼓励, 动机
republic	n. 共和国,共和政体
integration	n. 综合, 集成, 同化
viewer	n. 观看者，电视观众, 观察器
pen	n. 钢笔 v. 圈进
catalog	n. 目录, 大学概况手册, 商品型录 vt. 做目录, 分类说明, 名入列表 vi. 研究(手册或目录), (商品)在型录中明码标价
dependent	adj. 附属的,依赖的,悬垂的 n. 受经济援助者
deposit	vt. 存放, 堆积, 使沉淀 vi. 沉淀 n. 存款, 定金, 堆积物
mode	n. 方式,样式,模式,风格,时兴 [音乐] 调式
descend	vt. &vi. 降,传,降临
literally	adv. 逐字地, 按照字面上地, 不夸张地