ant	n. 蚂蚁
divert	vt. 转移,使欢娱 vi. 转移
sensory	adj. 知觉的, 感觉的, 知觉器官的
fatigue	n. 疲乏,疲劳,累活 adj. 疲劳的 vt. 使...疲劳,使...心智衰弱 vi. 疲劳
southeast	n. 东南, 东南地区 adj. 东南的, 向东南的, 来自东南的 adv. 往东南, 来自东南, 在东南
antibody	n. 抗体
breeze	n. 微风,轻而易举的事 vi. 飘然而行,轻松地得胜或进步
diameter	n. 直径
makeup	n. 组成(接通, 补给, 修理), 化妆品
aluminum	n. 铝
dense	adj. 不易看透的, 密集的, 浓厚的, 愚钝的
cheat	n. 骗子,欺骗行为 vt. &vi. 欺骗,作弊
kingdom	n. 王国，领域，界 Kingdom：天国
articulate	adj. 有关节的,发音清晰的 vt. &vi. 以关节连接,接合,明白地说
ridge	n. 脊, 山脊, 山脉
knit	vt. 编织, 密接, 结合, 皱眉 vi. 编织, 变得紧凑, 愈合 n. 编织
multiply	vt. 乘,增加 vi. 扩大,繁衍,做乘法 adv. 多样地,多重地
sphere	adj. 球体的 n. 范围, 领域, 球, 球体
reportedly	adv. 据报道, 据传闻
habitat	n. (动植物的)产地,栖息地
bracket	n. 支架, 括号, 档次 vt. 支撑, 放在括号内, 归入一类, 包含, 支持
plaster	n. 石膏, 灰泥, 膏药 v. 涂以灰泥, 敷以膏药, 使...平
gram	n. 克 abbr. 语法（=grammar） suf. 写出或画出的东西
chromosome	n. 染色体
builder	n. 建立者，建筑工人 n. 增洁剂
alternate	adj. 交替的, 轮流的, 间隔的 vt. &vi. 交替, 轮流
suppress	vt. 镇压,使...止住,禁止
globalization	n. 全球化 =globalisation(英)
modification	n. 修正, 修饰, 修改
basin	n. 脸盆, 盆地, 流域, 水池
aggression	n. 进攻, 侵犯, 侵害, 侵略
exceptional	adj. 例外的,异常的,特别的
analogy	n. 相似,类似，类比
defender	n. 防卫者, 拥护者, 辩护者
sponsorship	n. 发起(主办, 倡议, 赞助)
systematic	adj. 有系统的, 分类的, 体系的
commute	vi. 交换,通勤,折偿 vt. 交换,减刑,改变付款方式 n. 乘车上下班,通勤
continually	adv.不断地,频繁地
mound	n. 土墩, 堤, 小山 v. 筑堤, 用土堆防卫
tomb	n. 坟墓 vt. 埋葬
layout	n. 布局, 安排, 设计
viable	adj. 能生存的,可行的,能居住的的
artifact	n. 人工制品(制造物,石器)
flush	n. 流溢, 面红, 旺盛, 冲水(尤指冲马桶), 突然萌发, (纸牌)同花顺, 清一色 [计算机] 冲洗 vi. 脸发红, 冲刷, 旺盛成长 vt. 用水冲洗, 惊起(一群鸟), 抄...老窝, 使兴奋 adj. 丰足的,齐平的,满盈的 adv. 正直地, 羞涩地
accessory	adj. 附属的(副的,辅助的) n. 附件，同谋
thereafter	adv. 其后, 从那时以后
attendant	adj. 伴随的 n. 服务员, 侍从, 伴随物, 出席者
niche	n. 壁龛；合适的职业；商机，有利可图的市场(或形势等)； vt. 放入壁龛
fond	adj. 喜欢的；温柔的；宠爱的
velocity	n. 速度, 速率, 迅速
regulator	n. 调整者, 取缔的人, 调整器
manifest	n. 载货单,运货单,旅客名单 adj. 显然的,明白的 vt. 显示, 证实, 出示
mutation	n. 变化, 转变, 母音变化
sadness	n. 悲哀
offset	n. 抵销,支派,平版印刷,弯管 vt. 弥补,抵销,用平版印刷 vi. 形成分支
flank	n. 侧面, 侧腹, 腰窝肉 v. 攻击侧面, 面临着, 守侧面
hunger	n. 饥饿,渴望,饥馑 v. 饿,使...饥饿,渴望
blink	vi. 眨眼,闪烁,屈服,视若无睹 vt. 使眨眼,尽力用眨眼来遮掩（尤指眼泪),拒绝承认或面对, 用闪光灯传送信号 n. 眨眼,闪光,一瞬间
flaw	n. 缺点,裂纹,瑕疵,突然的狂风天气 vi. 变得有缺陷 vt. 使破裂
northeast	n. 东北 adj. 东北的, 向东北的, 来自东北的 adv. 向东北, 来自东北
temporal	adj. 当时的,暂时的,现世的 n. 世间的事物
inappropriate	adj. 不适当的,不相称的
originate	vt. 发起 vi. 开始 [计算机] 起始
standardize	v. 标准化, 使合于标准
noun	n. 名词
fossil	adj. 化石的 n. 化石,食古不化的人,过时的词
foul	adj. 恶臭的,污秽的,邪恶的,下流的 vt. 弄脏,妨碍,污蔑,阻塞,犯规 vi. 腐败,犯规 adv. 不正当地 n. 缠绕,犯规
stripe	n. 条纹 vt. 使...带有条纹的
flip	vt. 掷, 弹, 轻击 vi. 翻转 n. 空翻，浏览 adj. 无礼的, 冒失的, 轻率的
encouragement	n. 鼓励
rotate	vt. &vi. (使)旋转,轮流 adj. 车轮状的
supportive	adj. 支持的, 赞助的
sunlight	n. 日光, 阳光
nursery	n. 托儿所
axiom	n. 公理, 格言，自明之理
probable	adj. 很可能的 n. 很可能的事
cone	n. 圆锥体,锥形物,球果 vt. 变成锥形,削尖
transcribe	vt.（用不同的录音手段）转录； 抄写，誊写； 改编（乐曲）（以适应他种乐器或声部）
generalization	n. 一般化, 普遍化, 概括，泛论
openly	adv. 公开地，公然地, 直率地
valve	n. 瓣膜,阀门,电子管,真空管
geographical	adj. 地理的,地理学的 =geographic
notable	adj. 显著的, 著名的 n. 名人
friction	n. 摩擦,摩擦力,分歧
liter	n. 升, 公升(容量单位) =litre(英)
elicit	vt. 引出,诱探出
modem	调制解调器
albeit	conj. 虽然(即使)
comprehension	n. 理解(力),领悟
disastrous	adj. 灾难性的
non	adv. [拉]非，不是
tumor	n. 肿块
selfish	adj. 自私的, 利己的
metaphor	n. 隐喻,暗喻
gradient	n. 倾斜度,坡度,升降率 adj. 倾斜的,步行的,步行态的
sunshine	n. 阳光
super	adj. 超级的,极好的 n. 警官,管理人 adv. 特别,格外
inhibit	vt. &vi. 禁止,抑制 [计算机] 禁止
genetics	n. 遗传学
facet	n. 小平面, 方面, 刻面
calculus	n. 微积分
vacuum	n. 真空,空间,真空吸尘器 adj. 真空的,产生(利用)真空的 vt. &vi. 用吸尘器打扫
vague	adj. 模糊的,不明确的,说话含糊不清的,茫然的
dominance	n. 支配(控制, 统治, 权威, 优势)
incur	v. 招致,蒙受,遭遇
lord	int. 主, 天啊 n. 上帝, 主
cartoon	n. 动画片 vt. 为...画漫画
artwork	n. 艺术品，美术品，(总称）插图
accumulate	vt. 积聚,累加,堆积 vi. 累积
memorize	v. 记住, 记录, 记下
multi	n. 多种；多数
interestingly	adv. 有趣地
bilingual	adj. 双语的,用两种语言表达或书写的
delta	n. (河流的)三角洲
embody	vt. 代表, 使具体化, 包含,使(精神)肉体化
emit	v. 发出,放射,吐露 [计算机] 发射
emperor	n. 皇帝
cortex	n. 外皮，（大脑）皮层
unbelievable	adj. 难以置信的
psychologist	n. 心理学家
onion	n. 洋葱
biologist	n. 生物学家
proton	n. 质子
unintelligible	adj. 难以理解的； 莫明其妙的
confound	vt. 使困惑, 混淆, 挫败，诅咒 vt.
hop	n. 单脚跳,跳跃 vi. 单脚跳,跳跃,着手做某事 vt. 跳跃,跃过
quotation	n. 1．引语,语录 2．报价单 3．行情表
comparative	adj. 比较的,相当的 n. 对手
correction	n. 订正, 改正, 改正的地方
orchestra	n. 管弦乐队
pesticide	n. 杀虫剂
enlarge	v. 扩大, 增大
fundamentally	adv. 从根本上，基本地
bucket	n. 水桶 vt. 装在桶里 vi. 急急忙忙
compact	adj. 紧凑的,紧密的,简洁的 v. 使装满,使简洁
connector	n. 连接头
equality	n. 同等, 平等
speculation	n. 沉思, 推测, 投机
lump	n. 团, 块状,瘤,很多, 愚笨的人, 惩罚 vt. 聚成团, 合并考虑, 同等对待或分类, 笨拙地移动, 结块, 忍受 vi. 使成块状, 沉重地移动 adj. 整体的, 全部的, 块状的
skip	n. 跳跃,跳读 vt. &vi. 跳越,蹦跳,略过,跳过
erect	adj. 直立的,竖立的,笔直的 v. 竖立,使...直立,建筑
altitude	n. 高度,海拔,高地
impulse	n. 冲动, 驱动力, 倾向, 心血来潮 vt. 推动
wavelength	n. 波长, 波段
composite	adj. 合成的,复合的 n. 合成物, 复合材料 vt. 合成
reconstruct	vt. 重建, 修复, 重现
inhabitant	n. 居民
receptor	n. 受容器, 感觉器官, 摄取体
conceptual	adj. 概念上的
dancer	n.跳舞者,舞蹈演员
buck	n. 钱,鹿皮,(鹿皮等)制物,小伙子 vt. &vi. 猛然震荡,抵制
capitalist	n. 资本家，资本主义者 adj. 资本主义的，有资本的
ironically	adv. 说反话地, 讽刺地
cult	n. 宗教膜拜仪式,异教,狂热崇拜,个人崇拜
optimum	n. 最适宜 adj. 最适宜的
technician	n. 技术员,技师
respectable	n. 品格高尚的人 adj. 值得尊重的, 人格高尚的, 不少的
contradict	vt. 反驳,与...矛盾
demonstrator	n. 示威者，示范者
predator	n. 食肉动物,掠夺者
singular	adj. 个人的,单数的,独一的,唯一的,非凡的 n. 单数
infectious	adj. 传染的
residue	n. 残渣,剩余,余数
calorie	n. 卡，卡路里(热量单位) =calory
semi	adj. 一半的, 部分的, 不完全的 n. 二轮半拖车(挂车, 双轮拖车)
burial	n. 埋葬，葬礼,坟墓
whichever	adj. 无论哪个, 无论哪些 pron. 无论哪个
nutrition	n. 营养
excellence	n. 优秀, 卓越, 优点
approximate	adj. 大约的,近似的 vt. &vi. 接近,约等于
arouse	vt. 唤醒,激发,激起 vi. 唤醒
intimate	adj. 亲密的,私人的,秘密的 n. 密友 vt. 透露,暗示
alternatively	adv. 二者择一地, 做为选择
arrow	n. 箭，箭头 vi. 快且笔直的前进有如穿梭的箭
reign	n. 执政,君主统治时期,王朝 vi. 当政,统治,占优势,支配,盛行
declaration	n. 宣布, 宣言
flux	n. 流出,流量,涨潮,变迁,助熔剂 vt. 使熔化,使泻,涨 vi. 熔化
invisible	adj. 看不见的,无形的 n. 隐形人(或物品)
capillary	n. 毛细管 adj. 毛状的, 毛细管的
discourage	vt. 使气馁,阻碍
denote	vt. 象征,表示
canoe	n. 独木舟, 轻舟 v. 乘独木舟
definitive	adj. 决定性的，权威性的，确定的，限定的 n. 限定词
smoothly	adv. 平滑地,流畅地,流利地
snake	n. 蛇 vt.& vi. 蜿蜒,扭曲
allocation	n. 配置, 分配, 安置
bacterial	adj. 细菌的
deviation	n. 偏差数, 偏离，出轨，背盟
definite	adj. 明确的,一定的
secrete	v. 隐秘, 隐藏, 隐匿 v. 分泌
minus	adj. 负的,减的 n. 减号,负数,缺点 prep. 减去
warrior	n. 勇士, 战士
delicate	adj. 细致优雅的,微妙的,美味的 adj. 淡色的,淡味的 adj. 娇弱的,纤细的
villager	n. 村民
watershed	n. 流域，分水岭，转折点
plunge	n. 突然跌落, 跳水 vi. &vi. 投入, 骤降, 使...陷入, 全神贯注于
practitioner	n. 从业者
pragmatic	adj. 实际的, 实用主义的
respective	adj. 各自的, 分别的
obsession	n.[U]痴迷；困扰,成见 [C]使人痴迷的人（或物）
skeptical	adj. 怀疑的
fashionable	adj. 流行的, 时髦的
integral	adj. 构成整体所必需的,完整的 n. [数学] 积分, 完整, 部分
fatal	adj. 致命的, 毁灭性的, 决定性的
skull	n. 头骨,骷髅头 vt. 击打头部
innate	adj. 天生的,固有的
activate	v. 刺激,使...活动,创设
dual	adj. 双重的, 成双的 n. 双数
feather	n. 羽毛,心情,种类,服饰 vt. 用羽毛装饰 vi. 长出羽毛
physics	n. 物理学
supposedly	adv. 想来(恐怕, 按照推测)
exponential	adj. 指数的 n. 指数
tolerance	n. 忍耐力,宽容,容忍,公差
prestigious	adj. 享有声望的, 声望很高的
unchanged	adj. 无变化的
disposal	n. 处理,消除,销毁,处置 n. 弃菜碾碎器
dilemma	n. 困境,进退两难
ethical	adj. 伦理的；道德的；凭处方出售的
spectacle	n. 值得看的东西, 光景, 眼镜
elevate	vt. 举起,提拔,素养提升，鼓舞 vi. 变高
elevation	n. 提拔，海拔,提高 [计算机] 标高
socialize	vt. 使...社会化，使...社会主义化，使适应社会需要 vi. 交际
fracture	n. 破碎,骨折 vt. 破碎,破裂 vi. 断裂
fierce	adj. 猛烈的, 凶猛的, 残暴的, 强烈的
ashamed	adj. 感到惭愧,感到害臊,因为羞耻或勉强作某事
primer	n. 启蒙书, 识字课本
chess	n. 国际象棋
endanger	vt. 危及，危害
syntactic	adj. 句法的
axis	n. 轴,中枢
manipulate	v. 操纵,利用,假造 [计算机] 操作
miniature	n. 缩图,小画像 adj. 小规模的,纤小的
enrich	vt. 使富足,使肥沃，添加元素
numerical	adj. 数字的, 用数字表示的
alteration	n. 改变, 变更
historically	adv. 历史上地
maneuver	n. 演习,调遣,策略 vt. 调遣,演习,巧妙地操纵 vi. 调遣,演习,用计策
monk	n. 僧侣, 修道士
landmark	n. 陆标, 划时代的事, 地界标
discrete	adj. 不连续的 离散的 [计算机] 分离 离散
comma	n. 逗号，停顿，间歇 n. 银纹多角蛱蝶
appendix	n. 附录,阑尾
shuttle	n. 航天飞机；穿梭；梭子；穿梭班机、公共汽车等 vt. 使穿梭般来回移动；短程穿梭般运送 vi. 穿梭往返
spatial	adj. 空间的
pollute	v. 弄脏,污染 vt. 污染
closure	n. 闭合(闭包,结束,截流,罩子,围墙) vt 结束
corps	n. 军团
dye	n. 染料,染色 vt. 染 vi. 染色
contaminate	vt. 弄脏,污染
oversee	v. 向下看,了望,监督
soluble	adj. 可溶解的，可解决的
tuck	n. 缝摺,船尾突出部下方,食品,鼓声 vt. 打摺,卷起,挤进,畅饮 vi. 缝褶裥,缩拢,畅饮
commerce	n. 商业, 贸易
finite	adj. 有限的
obscure	adj. 微暗的,难解的,不著名的,[语音学]轻音的 vt. 使...阴暗,隐藏,使...含糊,成为含糊的元音 n. 暗淡,模糊
dependence	n. 依赖, 信赖，上瘾
regression	n. 复原,逆行,退步
deteriorate	vt. (使)恶化 vi. (使)恶化, 瓦解, 衰退
theology	n. 神学
sting	n. 刺痛；讽刺，刺激；刺毛 vt. 刺；驱使；使…苦恼；使…疼痛 vi. 刺痛；被刺痛；感到剧痛
noisy	adj. 喧闹的,嘈杂的 n. 嘈杂声,响声
selective	adj. 选择的, 选择性的
fluctuate	vi. 变动, 上下, 动摇 vt. 使动摇
doorway	n. 门口
blur	vt.& vi. 使...模糊,弄脏 n. 污点,模糊
follower	n. 追随者, 属下, 模仿者，信徒，[机]随动件
dolphin	n. 海豚
orientation	n. 信仰,趋向,定位,适应,情况介绍 [计算机] 定向
swift	adj. 快的,迅速的 adv. 快速地 n. 雨燕,线轴
texture	n. 质地；纹理；结构；本质，实质
differentiation	n. 区别,分化,变异
industrialization	n. 工业化
enjoyment	n. 享受
fin	n. 鳍,鱼翅,鳍状物,散热片,五元纸币 vt. 装上鳍片 vi. 露鳍于水面,拍动鳍, 象鱼一样游泳
algorithm	n. 算法
erupt	v. 爆发
ancestor	n. 祖宗,祖先,原种
sub	n. 潜艇,替代品 vi. 替代 vt. 转包合同
likewise	adv. 同样地,此外,（表示感觉相同）我也是
maternal	adj. 母亲的, 母系的, 母方的
remainder	n. 剩余物, 其他的人, 残余 vt. 廉价出售 adj. 剩余的
bead	n. 珠子,滴 vt. 用珍珠布置或覆盖，象珍珠一样串成线 vi. 形成珍珠
maximize	v. 取...最大值,最佳化 [计算机] 最大化
uplift	v. 提高, 振奋 n. 高扬, 道德的向上, 精神昂扬
weave	n. 编法, 织法, 编织 v. 编织, 组合, 编排
apparatus	n. 装置, 器具, 机构, 组织
adaptation	n. 改编,适应,改编成的作品
node	n. 节, 结节, 瘤, (戏剧情节的)曲折或纠纷 [计算机] 节点
laborer	n. 劳动者, 劳工 =labourer（英）
frontier	n. 边界,边境，尖端，边缘
liver	n. 肝脏
colorful	adj. 华美的, 富有色彩的, 有趣的
bleed	vi. 流血, (为事业,祖国)负伤或牺性, (花草p 树木等)流出汁液, 出大笔钱 vt. 放血, 勒索钱财, 大大削弱, 使...流血 n. 印刷到纸边上去,漏出
bloom	n. 花,钢块,兴旺 vt. 使...开花 vi. 开花,变得健康
vowel	n. 母音, 元音
behavioral	adj.动作的
prosperity	n. 繁荣,兴旺
bureaucracy	n. 官僚制度, 官僚主义
unwilling	adj. 不愿意的
protective	adj. 保护的, 防卫的
hepatitis	n. 肝炎
plague	n. 瘟疫, 麻烦, 灾祸 vt. 折磨, 烦扰, 造成麻烦
generic	adj.一般的,普通的,共有的，没有商标的 n. 无商标的药品
tablet	n. 药片, 匾, 片状物
variant	n. 变体 adj. 不同的
architectural	adj. 建筑的,建筑学的,建筑术的
conjunction	n. 连词, 结合, 关联,(事件等的)同时发生
slab	n. 平板, 厚的切片 v. 切成厚板, 以平板盖上
positively	adv. 必定地, 确实地, 断然地, 绝对地, 积极地
pulse	n. 脉冲,脉波,脉搏 vt. &vi. 跳动,脉跳
thorough	adj. 彻底的, 完全的, 精心的
wilderness	n. 荒野, 荒地
fungus	n. 真菌, 霉菌 （复数为funguses或fungi)
elementary	adj. 基本的,初级的,元素的
rigid	adj. 僵硬的,刻板的,严格的
container	n. 容器, 集装箱
elimination	n. 除去, 消除
nationalism	n. 民族主义, 民族之特性
corpus	n. [计] 语料库；文集；本金
sword	n. 剑,刀, 致命或毁灭性器械, 剑状物,使用武力, 军事裁判权
synthetic	adj. 综合的,合成的,人造的 n. 人工制品
hemisphere	n. 半球
circulation	n. 流通,循环,发行量,消息传播
marble	adj. 大理石的,冷酷的 n. 大理石 vt.使有大理石的花纹
shallow	adj. 浅的, 肤浅的, 浅显易懂的 n. (pl.)浅滩, 浅处 v. 变浅
subset	n. 子集
imperative	n. 命令, 诫命, 需要 adj. 命令式的, 急需的
derivative	adj. 引出的,系出的 n. 引出之物,系出物,衍生字 n. 导数, 微商
alien	n. 外侨;外星人 adj. 外国的,相异的，陌生的 vt. 转让
quiz	n. 随堂测验,恶作剧,古怪的人 vt. 恶作剧,提问
nutrient	adj. 营养的,滋养的 n. 营养物,营养品
shield	n. 盾,防卫物,盾状物 vt. 保护,遮蔽
adjacent	adj. 毗连的,邻近的,接近的
semantic	adj. 语义的
abdominal	adj. 腹部的
creator	n. 创造者，[计]创建者 Creator n. 上帝
paradox	n.反论，悖论； 似非而是的论点； 自相矛盾的人或事； [物]佯谬
illuminate	vt. 照明,阐释,说明
entrant	n. (参加比赛的)竞赛者, 新就业者, 新成员
compatible	adj. 能共处的,可并立的,适合的, 兼容的 n. 兼容
warmth	n. 暖和, 温暖, 热烈, 热情, 热心
substitution	n. 代理,替换,交换
inexpensive	adj. 花费不多的，廉价的
accomplishment	n. 成就,完成
fragile	adj. 易碎的,脆的,精细的
phosphate	n. 磷酸盐，磷肥，磷酸果汁汽水
epic	n. 史诗,叙事诗 adj. 史诗的,叙事诗的,宏大的,壮丽的
tricky	adj. 狡猾的,欺骗的,棘手的
relay	vt. 中继,用继电器控制,接替,传递 n. 替班人,接力赛,继电器,传递
trillion	n. 万亿, 大量, 兆 adj. 万亿的, 兆的
crumble	v. 崩溃, 弄碎, 减亡
silk	adj. 丝的 n. 丝, 绸
variability	n. 易变, 变化性, 变异性
residual	adj. 残余的,剩余的 n. 剩余部分, (复)追加酬金
mold	n. 模子,模型,类型,模式,雏型,真菌,软土 vt. 形成,形成,制模,发霉 vi. 符合形状,发霉
telescope	n. 望远镜 v. 缩短, 压缩
cyclic	adj.循环的，周期性的，环形的
stabilize	v. 使安定, 使坚固
inference	n. 推理,推论
jungle	adj. 丛林的,蛮荒的 n. 丛林,密林
critically	adv. 批评性地, 爱挑剔地, 重要地, 危急地
refine	vt. 精炼,净化,使优雅 vi. 被提纯,改进
refuge	n. 避难(处), 庇护(所) v. 庇护, 避难(所)
circa	prep. 大约
instability	n. 不安定,不稳定,基础薄弱
textile	adj. 纺织的 n. 纺织品
chronic	adj. 长期的,慢性的,惯常的
biodiversity	n. 生物多样性
cereal	adj. 谷类(的),谷物(的) n. 谷类食物
decisive	adj. 决定性的；果断的，坚定的
poorly	adv. 贫穷地，不充份地，贫乏地 adj. 身体不舒服的，心情恶劣的
gel	n. 凝胶,发胶,彩色透明滤光版 vi. 形成胶冻
sensation	n. 感觉,感知力,激动,轰动
taxpayer	n. 纳税人
wax	n. 蜡,蜡状物,震怒 vi. 变大,增大,月亮满 vt. 用蜡涂
decoration	n. 装饰, 装饰品
degrade	vt. 贬低；使……丢脸；使……降级；使……降解 vi. 降级，降低；退化
orient	adj. [诗]东方的,闪闪发光的 n. 东方,珍珠,东方国家 vt. 使向东,确定方向,定位,以...为参照,使熟悉或适应 vi. 转向东方
jar	n. 不和谐,刺耳声,震动,震惊,广口瓶 vi. 发刺耳声,不协调,震动 vt. 扰乱,使不稳定
patience	n. 耐心,毅力
invoke	vt. 求助,用咒语召唤,请求,应用,引起 [计算机] 调用
irrelevant	adj. 不恰当的,无关系的,不相干的
displacement	n. 换置, 转位, 移动 [计算机] 位移
soak	n. 浸,湿透,喝醉 vt. 使…湿透,浸泡在液体中,浸洗，吸入，使某人喝醉，向某人敲竹杠 vi. 浸入液体，渗透，感化（某人），无节制地喝酒
hammer	n. 锤,榔头 vi. 锤击,反复敲打 vt. 锤打,严厉批评
carrot	n. 胡萝卜,报酬,好处
planner	n. 计划者，设计者
onwards	adv. 向前，前进，在前面 =onward
wool	n. 毛线,毛织品,羊毛
inhibition	n. 禁止, 禁制, 压抑
peculiar	adj. 奇怪的,古怪的,特殊的,独特的 n. 特权
justification	n. 辩护, 证明正当, 释罪 [计算机] 对齐
penetrate	vt. &vi. 穿透,渗透,看穿
harmony	n. 和弦,协调,和睦,调和
cellular	adj. 细胞的,松织的 n. 手机
hormone	n. 荷尔蒙, 激素
wildlife	n. 野生动物
disregard	n. 不理会, 漠视 vt. 忽视, 不顾
marker	n. 标记，做记号的工具,做记号的人,记分员
lengthy	adj. 冗长的, 漫长的
predominantly	adv. 优越地,卓越地,主要地
desirable	adj. 值得有的,令人满意的,有吸引力的 n. 有吸引力的人
hatch	n. 孵化,舱口 vt. 孵,孵出 vi. 孵化，破壳
epidemiology	n. 传染病学，流行病学
credibility	n. 可信用, 确实性, 可靠
slash	vi. 大幅度削减 vt. 猛砍,尖锐抨击,大幅减少 n. 猛砍,斜线,长切口,衣衩
unaware	adj. 没有发觉的, 不知道的
photographic	adj. 摄影的，逼真的
adverse	adj. 不利的；有害的；反面的
antibiotic	adj. 抗菌的 n. 抗生素
hawk	n. 鹰,掠夺别人的人,鹰派人物 n. 清嗓 v. 用训好的鹰捕猎,像鹰一般地袭击,鹰啸，清嗓 v. 沿街叫卖
tolerate	v. 忍受,容忍,容许,宽恕 vt. 容忍,忍受,容许
mammal	n. 哺乳动物
excessive	adj. 过多的,过分的
marginal	adj. 边际的,末端的,仅以微弱多数获胜的,微小的
specimen	n. 样本,标本
anytime	adv. 任何时候；无例外地
swap	n. 交换 vt. &vi. 交换,用...作交易
diffusion	n. 散布, 传播, 蔓延
whereby	adv. 借此(在...旁,凭什么)
spill	vt.& vi.溢出； 泼出； 涌出； 蜂拥而出 n.洒出； 泼出； 溢出；小塞子
pipeline	n. 管道, 管线
chew	vt. 咀嚼,嚼碎,损坏 vi. 咀嚼 n. 咀嚼,咀嚼物
splice	v.&amp;n. 接合,衔接 vt. 拼接
hello	int.（见面打招呼或打电话用语）喂,哈罗
mysterious	adj. 神秘的,不可思议的
spoon	n. 匙,匙形的铲子 vt. 以匙舀起
dirt	n. 污垢,泥土, 污秽的言行,卑鄙的人,堕落,矿渣
lag	n. 落后, 滞后, 落后的人, (两事件之间的)时间间隔, 耽搁, 桶盖 vt. 落后, 投掷, 盖上桶盖, 耽搁 vi. 走得慢, 落后 adj. 最后的
herd	n. 兽群,人群,牧人 vt. 群集,使...成群,放牧 vi. 聚在一起
sibling	n. 兄弟姐妹
spur	n. 马刺, 刺激, 鞭策, 支脉, (公路或铁路的)支线, vt. 以马刺策(马)前进, 刺激, 激励, 给(马)装马刺
capitalism	n. 资本主义
parenthesis	n. 圆括号, 插入语, 插曲，间歇,停歇
census	n. 户口普查 v. 实施统计调查
autonomy	n. 自治
plural	adj. 复数的 n. 复数
monopoly	n. 垄断,专利, 独占，控制
realism	n. 写实主义, 现实主义
morality	n. 道德, 美德, 品行, 道德观
expedition	n. 远征,探险队,迅速
imperial	adj. 帝国(王)的,至尊的,特大的 n. 皇帝, 女皇, 马车车顶, 特大号, 特级品
luckily	adv. 幸运地, 幸亏地
formally	adv. 正式地, 形式上地
conditional	adj. 有条件的, 假定的，假设的 n. [语]条件句
conserve	n. 蜜饯,果酱 vt. 保存,与糖放在一起,保持
starve	v. 使饿死, 饿得要死
lazy	adj. 懒惰的
ruler	n. 尺子 n. 统治者
exotic	adj. 异国的,外来的,奇异的,脱衣舞的 n. (复数)异国风格的事物,脱衣舞者
explosive	adj. 爆炸(性)的 n. 炸药
thesis	n. 毕业论文, 论题, 论文
nitrogen	n. 氮
continuously	adv.不断地,连续地
daytime	n. 白天, 日间
scroll	n. 卷轴,目录 vt.& vi. 卷动
turkey	n. (Turkey)土耳其,火鸡,笨蛋,失败之作
aspiration	n. 渴望；抱负；送气；吸气；吸引术
tightly	adv. 紧紧地, 坚固地
simulation	n. 模拟,仿真,赝品
communicative	adj. 健谈的，爱说话的, 畅谈的
oak	n. 橡树, 橡木 adj. 橡木制的
flap	n. 拍打，拍打声；襟翼 vt.& vi. 拍打,鼓翼而飞,飘动
physiological	adj. 生理的, 生理学的
downward	adj. 向下的 adv. 向下
interviewer	n. 采访者, 接见者, （面试时的）主考官
northwest	n. 西北, 西北方 adj. 西北的, 在西北的, 来自西北的 adv. 向西北
tribute	n. 贡品,颂词,称赞,(表示敬意的)礼物
lick	n. 舔,少许,打 vt. 舔,连续击打,击败 vi. 用舌头舔,拍打
indifference	n. 不重视, 无兴趣, 漠不关心
formulation	n. 形成, 简洁陈述, 公式化
overlap	n. 重叠,重复 vt. 重叠,重复 vi. 有重叠部分 [计算机] 重叠
chemotherapy	n. 化学疗法
endeavor	n. 努力, 尽力, 进取心 vt. 努力,尽力 vi. 企图, 谋求
fortunate	adj. 幸运的,侥幸的
epidemic	n. 传染病, 流行病 adj. 流行的, 传染性的
erase	v. 抹去,擦掉 [计算机] 擦除
imitate	v. 模仿 vt. 仿制,仿造,模仿,仿效
scent	n. 气味,香味,痕迹 vt. 闻出,发觉,使充满味道,得到...的暗示 vi. 嗅闻,循着遗臭追踪,散发气味
primitive	adj. 原始的 n. 原始人,文艺复兴前的艺术家
prince	n. 王子, 亲王, 佼佼者
proliferation	n. 增殖,分芽繁殖
tract	n. 广阔的土地,地域,器官系统,宣传小册子
matrix	n. 母体,子宫 细胞 脉石,字母 n.矩阵
uphold	v. 支撑, 赞成, 鼓励
lion	n. 狮子
nominal	adj. 名义上的,有名无实的,名词性的 n. 名词词组
dissertation	n. 论文
subtract	vt. 扣掉 vi. 减少
accumulation	n. 积聚, 累积, 积聚物
competent	adj. 有能力的,胜任的,足够的
bark	n. 狗叫,咆哮,厉声说话,树皮,小帆船 vi. 吠叫,咆哮,急促地说 vt. 咆哮,叫卖,撕(表皮)
acidic	adj. 酸的,酸性的
arch	n. 拱门,弓形 vt. 使成弓形弯曲, 拱起 vi. 成弓形, 用拱连接 adj. 主要的,调皮的
administrator	n. 管理人,行政官
successive	adj. 接连的, 连续的, 接二连三的
efficiently	adv.有效率地,有效地
consonant	n. 辅音 adj. 一致的,调和的,辅音的
mentor	n. 指导者 vt. 指导
ash	n. 灰, 灰烬
upright	adj. 正直的, 诚实的, 合乎正道的
seldom	adv. 很少 adj. 很少的
metabolism	n. 新陈代谢
warehouse	n. 仓库 vt. 存入仓库
athletic	adj. 运动的,活跃的,健壮的
methodology	n. 一套方法,方法学
utterance	n. 说话, 发表, 说话的方式
bypass	vt. 绕开, 忽视 n. 支路，旁道
surgeon	n. 外科医生
pi	n. 圆周率
chloride	n.[化]氯化物
portrayal	n. 描绘，肖像，画像
imaginative	adj. 富于想象力的
implicit	adj. 暗示的,盲从的 [计算机] 隐式
vanish	vi. 消失,不见了,绝迹 vt. 消失
elastic	adj. 有弹性的,灵活的,可变的 n. 橡皮圈,有松紧的东西
generator	n. 发电机, 发生器
handout	n. 散发材料(免费发给的新闻通报)
mechanic	adj. 手工的 n. 技工,机修工
frog	n. 蛙,马的蹄叉,刀剑的挂环
censor	n. 检查员, 潜意识的抑制,为Freud学派的术语 v. 检查
initiation	n. 开始, 启蒙, 入会
coronary	adj. 冠状的, 冠状动脉或静脉的，心脏的 n.冠状动脉或静脉，冠状动脉血栓形成，心脏病发作
lateral	adj. 侧面的,横向的,旁边的 n. 分流,后传,后音 vi. 完成横向穿越
disturbance	n. 扰乱,骚动
yeast	n. 酵母
heighten	v. 增高,提高,加强
progression	n. 前进
vigorous	adj. 精力充沛的,元气旺盛的,有力的
tailor	n. 裁缝师,成衣匠 vt. 缝制,适应,试穿,修改 vi. 做裁缝
millimeter	n. 毫米
counselor	n. 顾问, 参事, 法律顾问
transparency	n. 透明度, 幻灯片
weed	n. 杂草,菸草 vi. 除草 vt. 除草,摆脱
attain	vt. &vi. 达到,获得
coherent	adj. 互相耦合的,清晰的，明了的，凝聚性的,连贯的
rack	n. (行李)架,拷问台,齿轨 vt. 折磨,使痛苦,拷问 vi. 顶风飞行
humanitarian	n. 人道主义者, 博爱者, 基督凡人论者 adj. 人道主义的, 博爱的, 相信基督为凡人的
constrain	vt.强迫； 强使； 限制； 约束
rainfall	n. 降雨，降雨量
bronze	adj. 青铜色的 n. 青铜, 青铜色, 青铜制品, 铜牌(第三名) vt. 使成青铜色
radius	n. 半径,桡骨,半径范围,辐射区
theorist	n. 理论家
ounce	n. 盎司
completion	n. 完成,完满
molecular	adj. 分子的
creep	vi. 爬, 蔓延 n. 爬, 徐行, 蠕动
settler	n. 移居者；殖民者
buffer	n. 缓冲,缓冲区 vt. 减轻,缓冲
crude	adj. 粗鲁的,简陋的,天然的,未加工的 n. 原油
contend	vi. 奋斗,斗争,辩论 vt. 坚持认为,竞争
goat	n. 山羊,好色之徒,替罪羔羊
specialty	n. 专门,特别,特性,特产
correlate	n. 有相互关系的东西, 相关物 v. 使有相互关系, 互相有关系
debris	n. 碎片, 残骸
appetite	n. 爱好,嗜好,食欲,胃口,欲望
gradual	adj. 逐渐的, 逐步的
cushion	n. 垫子, 橡皮软垫, 缓冲 vt. 加垫褥, 放在垫子上, 保护, 减缓, 为...装垫子
China	n. 瓷器；中国 adj. 瓷制的（小写时）
therapist	n. 临床医学家
cargo	n. 船货, 货物
neuron	n. 神经元, 神经细胞
palm	n. 手掌, 棕榈树 vt. 把...藏于手中, 用手掌击(球)
cylinder	n. 汽缸, 圆筒, 圆柱体
slavery	n. 奴役，奴隶制，奴隶身份
unify	v. 统一,使成一体
width	n. 宽度,广度,某一宽度的材料
vegetation	n. 植物,草木,(植物)生长
verbal	adj. 动词的,口头的,用言辞的,用文字的 n. 动名词
partially	adv. 部份地, 一部份地, 不公平地
deficiency	n. 缺乏,不足,缺点
polar	adj. 两极的,南辕北辙的,极地的 n. 极线,极性
disrupt	adj. 分裂的,分散的 v. 使...分裂,使...瓦解
mercy	n. 怜悯, 宽恕, 仁慈, 恩惠, 幸运
inability	n. 无能,无力
decay	n. 衰退, 腐败 v. 衰退, 腐败
shipment	n. 装船,货物,出货
shorten	v. 弄短, 变短
pavement	n. 人行道
economical	adj. 节俭的, 经济的, 合算的
syllable	n. 音节 vt. 分音节
approximation	n. 接近，近似，近似值
miner	n. 矿工
distinctive	adj. 有特色的,出众的
aerosol	n. 浮质，喷雾剂
peasant	n. 农民 n. 民工
aggregate	n. 合计, 总计, 集合体 adj. 合计的, 集合的, 聚合的 v. 聚集, 集合, 合计
grin	v. 露齿而笑，咧着嘴笑 n. 露齿笑
respiratory	adj. 呼吸的
worm	n. 虫,蠕虫 vt. 蠕动,驱虫,慢慢探听出 vi. 蠕动
dairy	adj. 牛奶的 n. 牛奶场, 乳品店, 乳制品
worship	n. 崇拜, 爱慕, 做礼拜 vi. 做礼拜 vt. 崇拜, 爱慕
disperse	vt. 分散,传播,散开 vi. 分散
sniff	n. 以鼻吸气,吸入的东西,吸气(声),一股气味 vi. 用鼻吸气,嗤之以鼻,找出 vt. 用鼻吸气,以轻蔑的口吻说,嗅到
linear	adj. 直线的，线性的，长度的
feasible	adj. 可行的,可能的
harmful	adj. 有害的
timber	n. 木材,木料
soften	v. 使...变柔软,变柔和,减轻
permanently	adv. 永久地
philosopher	n. 哲学家，思想家，达观者
certainty	n. 确定, 确实的事情
spice	n. 药料, 香料, 情趣 vt. 用香料调味
spiral	n. 旋涡, 螺旋形之物 adj. 螺旋形的, 盘旋的 v. 成螺旋状下降或上升, 成螺旋状旋转
evolutionary	adj. 发展的(展开的,调优的)
oxidize	v. 氧化,生锈 vt.&amp;adv. 使氧化
exploitation	n. 开发,开采,自私的利用
dialect	n. 方言
atomic	adj. 原子的, 原子能的
configuration	n. 结构,布局,形态,格式塔心理完形 [计算机] 配置
dictate	vi. 听写 vt. 口述,口授 n. 命令,指挥,指令
prevalence	n. 传播, 流行, 普及
morphology	n. 形态学，语形论，形态论
fetch	n. 取得 vt. 取来,带来,航行到达 vi. 取回,兜圈子
fever	n. 发烧,狂热 vt. 激怒 vi. 发烧
pine	n. 松树,松木 vi. 消瘦,憔悴,渴望
automobile	n. 汽车 adj. 汽车的
empirical	adj. 经验主义的
onset	n. 攻击, 进攻, 肇端
chill	n. 寒冷,寒意,失意, 恐惧 adj. 寒冷的,冷漠的，感冒的, 扫兴的 vt. 使...寒心,冷冻,使...惊恐, 使泄气 vi. 变冷，发抖, 凝固, 感到寒冷
rocky	adj. 岩石的, 像岩石的，坚硬的，麻木的
footnote	n. 脚注, 补充说明 vt. 给...作脚注
entail	vt. 使必需,使蒙受;限定继承 n. 限定继承权
lecturer	n. 演讲者, 讲师
circular	adj. 循环的,圆形的 n. 传单,通报
disgust	n. 厌恶,嫌恶 vt. &vi. 令人厌恶
rose	n. 玫瑰,蔷薇 v. (rise的过去式) 起立,上升,升起 adj. 玫瑰色的,玫瑰的
privately	adv. 私下地，秘密地
haul	n. 拖;大批赃物;一网的捕获量;拖运货物的距离 vt. 用力拖拉,用车运送,改变方向,把某人带上来审问或训斥 vi. 拉,行进,提供交通,改变风向
classification	n. 分类,分级
taxation	n. 课税, 征税, 税金
computation	n. 计算，计算机的使用，计算方法，计算结果
polish	n. 磨光，擦亮；擦亮剂；优雅，精良 vi. 擦亮，变光滑 vt. 磨光，使发亮；使完美; 改进 v. 磨光；修改；润色 adj. 波兰的
evoke	vt. 唤起,引起
arc	n. 弧,弧形物 vi. 形成电弧,按弧形轨迹行进
recipient	n. 接受者, 收信人
triangle	n. 三角(形)
nucleus	n. 核,核心,细胞核,原子核
hollow	n. 洞, 窟窿, 山谷 adj. 空的, 虚伪的, 空腹的 vt. 形成空洞, 挖空 vi. 形成空洞 adv. 有闷哑声, 完全地
static	n. 静电, 静电干扰, 噪声, 阻碍, 抨击 adj. 静态的,静电的,固态的
statue	n. 塑像,雕像
spider	n. 蜘蛛
independently	adv.独立地,自立地
protocol	n. 草案, 协议,礼仪 vt 拟定议定书
horizontal	adj. 水平的,横的 n. 水平线,水平面
horn	n. 喇叭 n.(牛、羊等的)角, 喇叭, 触角 v.装角
terrain	n. 地带,地域,地形
threshold	n. 极限,门槛,入口,开端
collaboration	n. 合作, 通敌
null	adj. 无效力的,无效的,无价值的 n. 零 [计算机] 空 vt. 使无效
powder	n. 粉,粉末,细雪,火药 vt. 洒粉于,使变成粉,重击 vi. 变成粉,涂粉
admiration	n. 钦佩, 赞赏
offspring	n. 子孙, 后代, 产物
ideological	adj. 意识形态的，思想上的
collision	n. 碰撞, 冲突
embed	vt. 栽种，使嵌入，使深留脑中
precision	n. 精确,精密度 adj. 以精准的执行而著称的, 经得起极精细测量的
discard	n. 丢牌,废牌 vt. 丢弃,抛弃 vi. 丢牌
offshore	adj. 海面的,吹向海面的 adv. 向海面
transplant	vt. 移居, 移栽(植物), 移植(器官) vi. 能经得住移植 n. 移植, 被移植的事物
forehead	n. 额,前额
toddler	n. 初学走路的孩子
messenger	n. 报信者, 先驱
memorable	n. 值得纪念的事物 adj. 值得纪念的
formulate	vt. 规划；用公式表示；明确地表达
randomize	vt. 形成不规则分布，使...随机化
sustainable	adj. 可以忍受的；足可支撑的；养得起的；可持续的
individually	adv. 个别地，单独地，独特地
diagnostic	adj. 特征的,诊断的 n. 诊断程序, 症状, 诊器
amusement	n. 娱乐, 消遣
limb	n. 树枝,四肢,枝干,边缘 vt. 切断手足,切断树干
patron	n. 赞助人, 保护人, 老主顾
fusion	n. 融合物,结合,融合
constructive	adj. 建设性的, 构造上的, 作图的
algebra	n. 代数学
vector	n. 向量,矢量,带菌者 vt. (无线电)导引 adj. 向量性的
adaptive	adj. 适合的,适应的,能适应的
occurrence	n. 发生,事件,发现
unstable	adj. 不稳定的，易变的
peripheral	adj. 不重要的,外围的 n. 外围设备
blade	n. 刀锋, 刀口
quantum	n. 分配量, 额, 量
frown	n. 皱眉, 不悦 vt. &vi. 皱眉头, 不同意
void	n. 空虚,空白, 真空 adj. 空的,缺乏的,无效的 vt. 清空,释放,取消,离开 vi. 排泄
pest	n. 害虫
nicely	adv. 漂亮地, 爽快地, 恰好地
gossip	n. 闲聊,随笔 vi. 散播流言蜚语
convergence	n. 汇聚,汇合点,收敛
omit	vt. 省略,疏忽,遗漏
fetal	adj. 胎儿的,胎的
aboard	adv. 在船上,在火车上,在飞机上 prep. 上船，上飞机，上车
contributor	n. 贡献者, 捐助者, 赠送者，投稿人
linguistics	n. 语言学
gasoline	n. 汽油
developmental	adj. 发展上的, 进化的，开发的
absorption	n. 吸收,全神贯注
immune	adj. 免除的,免疫的 n. 免疫者
acceleration	n. 加速,促进,加速度
millennium	n. 一千年, 太平盛世
loop	n. 环,圈,弯曲部份,回路 vt. 使...成环,以圈结,以环连结 vi. 形成环,环形地行动
precipitation	n. 坠落, 沉淀, 凝结; 冰雹
genius	n. 天才, 高智力, 天赋
media	n. (medium的复数)媒体,新闻媒介,传播媒介
urine	n. 尿
geography	n. 地理
cue	n. 字母Q,信号,线索,球杆 vt. 暗示,用球杆打球 vi. 使用球杆
fertilization	n. 受精，肥沃化
morphological	adj.形态学(上),语形学的
bud	n. 芽, 花蕾 vi. 发芽, 萌芽 vt. 使发芽
verify	v. 查证,核实 n.[计算机] DOS命令 : 打开关闭在 DOS操作期间的写文件校验开关
prey	n. 被掠食者,牺牲者 vi. 捕食,掠夺,使...苦恼
migration	n. 移民,移往,移动
principally	adv. 主要地
lesser	adj. 较少的, 较小的, 次要的
contradiction	n. 反驳,矛盾,不一致,否认
bee	n. 蜜蜂
severely	adv. 严重地(艰难地, 紧凑地, 纯朴地)
MA	n. &lt;口&gt;妈
monetary	adj. 货币的,金融的
avenue	n. 林荫道, 大街, 途径手段
postgraduate	n. 研究生 adj. 大学毕业后的
closet	n. 壁橱,衣帽间 adj.（用于名词前）隐藏（身分等）的；不公开（个人信息）的 vt. 把…关在房间里（尤指为了私下会谈或避免他人打扰）
mat	n. 垫,丛,衬边,消光面 vt. 遮盖, 保护, 用垫子装饰, 使纠缠,铺席于...上,使...无光泽,给(照片)镶框 vi. 缠结
optical	adj. 眼睛的, 视觉的, 光学的
coincide	v. 与...一致,符合,暗合
anti	n. 反对者 adj. 反对的 prep. 反对
voyage	n. 航行,旅程 vt.& vi. 航行,旅行
organism	n. 生物体, 有机体
motif	n. 主题, 意念, 动机
alright	adj. <非标准用语>很好的，没问题的，满意的 adv. 很好，没问题地，令人满意 =all right
potassium	n. 钾
ideology	n. 观念学, 空论, 意识形态
indirect	adj. 间接的, 迂回的，次要的，不坦率的，欺骗的
glory	n. 光荣,荣誉,壮丽,赞颂 vi. 为...而骄傲自豪 interj. 用于表示惊叹
envy	vt. &vi. 嫉妒,羡慕 n. 妒忌,羡慕
lens	n. 镜头,透镜
realization	n. 实现,领悟,实得
plausible	adj. 似真实的,似合理的,说得蛮像回事的
plow	n. 犁,耕地 vt. 耕犁, vi. 用犁,费力前进,辛苦进行
complication	n. 并发症；复杂；复杂化；混乱
woodland	n. 森林地, 林地 adj. 林地的
inhabit	v. 居住于, 占据, 栖息
mole	n. 痣, 鼹鼠
conception	n. 概念,观念,构想,怀孕
ink	n. 墨水
preservation	n. 保存
conform	vt. 使一致,遵守,使顺从 vi. 一致,符合
outlook	n. 观点,见解,展望,前景
constituent	n. 成份,选民,构成物 adj. 构成的,组织的,有提名权的
rhetoric	n. 修辞, 华丽虚饰的语言, 修辞学
variance	n. 不一致, 变化; [数]方差
simplicity	n. 单纯, 简朴
simplify	v. 简化, 使单纯 vt. 简化
longitudinal	adj. 经线的, 纵向的, 长久的
tutor	n. 家庭教师,导师 vt. 监护,指导 vi. 当导师(私人教师)
instantly	adv. 立即地, 即刻地
estimation	n. 判断, 估计, 尊重
instinct	n. 本能, 天性, 直觉
replicate	vt. &vi. 折叠,复制,模写 n. 同样的样品 adj. 转折的
cultivate	vt. 培养,耕作,栽培,结交(朋友), 促进增长, 教养
mathematical	adj. 数学的，精确的，可能性极小的
unfamiliar	adj. 不熟悉的
insure	vt. 保险,确保 vi. 买保险
applicable	adj. 合适的,适用的
inject	v. 注射
countless	adj. 无数的，数不尽的
retrieve	vt. 挽回,恢复,回忆,补偿 vi. 找回猎物 n. 取回,恢复
cage	n. 笼子 v. 关入笼中 vt. 把...关入笼内
calcium	n. 钙
textbook	n. 课本, 教科书
dam	n. 水坝 vt. 筑坝,抑制(情感）等
intermediate	adj. 中级的,中间的 n. 中间体,媒介物, 调解人 vi. 调解, 干涉
hydrogen	n. 氢
parcel	n. 包裹，小包 vt. 打包；捆扎
invade	vt. 侵略,侵害,拥入
hierarchy	n. 等级制度，层级[计],统治集团
conceal	vt. 隐藏, 掩盖
ion	n. 离子
Mercury	n. 水银, 水星
irregular	n. 不合规格之物 adj. 不规则的, 不整齐的, 不合法的
shatter	n. 碎片,乱七八糟的状态 vt. 打碎,破掉,散开 vi. 打破,脱落
deceive	vt. 欺骗 vi. 行骗
rejection	n. 拒绝, 被弃, 被抛弃的实例
oscillation	n. 振动, 动摇, 彷徨，振幅，单一的振动循环
descent	n. 下落,家世,倾斜,侵袭
deed	n. 事迹, 行为，（尤指房产）契约，证书 vt. 通过行为转化
deepen	vt. 使...加深, 使...强烈 vi. 加深，变浓
deer	n. 鹿
thoughtful	adj. 深思的,体贴的
diagnose	v. 诊断 vi. 判断,诊断(疾病) vt. 诊断(疾病)
reproduce	v. 再生, 复制, 生殖
aesthetic	adj. 美学的,审美的,有美感的 n. (复数)审美观
inclusion	n. 包含
likelihood	n. 可能性
ecological	adj. 生态的, 生态学的
hardship	n. 艰难, 困苦
align	vt. 使成一行, 使一致, 使结盟, 调整, 排列 vi. 成一条线
inferior	adj. 次等的, 较低的, 不如的
distort	vt. 变形,扭曲,歪曲 vi. 歪曲
predictable	adj. 可预言的
scripture	n. 经文，圣书，手稿 Scripture: (常用复数)《圣经》，《圣经》中的一段
monkey	n. 猴子 v. 胡闹, 乱弄
dimensional	adj.空间的
lexical	adj. 字典的, 语句的
southwest	n. 西南, 西南风, 西南地区 adj. 西南的, 来自西南方的 adv. 往西南, 来自西南
speculate	vt. 推测,好奇 vi. 深思,投机
magnitude	n.巨大，广大； 重大，重要； 量级； （地震）级数
devise	vt. 设计,遗赠 n. 遗赠(的财产)
beast	n. 畜牲 n. 凶残的人, 令人厌憎的人
stalk	n. 茎,追踪,高视阔步 vt.& vi. 悄悄靠近,蔓延,高视阔步
dial	n. 刻度盘,针面,转盘 vt. 用仪表测量，操作仪表 vi. 拨号，用仪表测量 [计算机] 拨号
rib	n. 肋骨,嘲笑 vt. 嘲笑
ecology	n. 生态学
economically	adv. 在经济上，节约地
antiquity	n. 高龄, 古老, 古物, 古迹
fertility	n. 肥沃, 丰饶, 生产力
solvent	n. 溶剂,解决者 adj. 有偿付能力的,有溶解力的
abundance	n. 丰富,充裕
chemistry	n. 化学,化学性质,相互作用
additionally	adv. 另外(加之, 又)
splash	n. 飞溅的水, 污点, 卖弄 v. 溅湿, 溅开
splendid	adj. 辉煌的；灿烂的；极好的；杰出的
migrate	v. 移动,移往,随季节而移居 [计算机] 迁移
tech	n. 技术人员，技术科技 abbr.(=technical, technically, technological)
livestock	n. 家畜, 牲畜
rocket	n. 火箭, 烟火 v. 发射火箭, 猛涨
locus	n. 场所, 所在地, 轨迹
supervise	vt. 监督,管理,指导
circulate	vi. 流通,循环,传播 vt. 使流通
paradigm	n. 例子,模范,词形变化表
ample	adj. 充足的,丰富的,宽敞的
autonomous	adj. 自治的
premiere	v. 初次公演, 初演主角
applause	n. 鼓掌, 喝彩, 赞许
archaeology	n. 考古学，古迹，文物
dissolve	vt. 消除,解散,使溶解,解决(问题),使沮丧 vi. 消散,溶解, 解散, 液化,变得模糊 n. 叠化画面
clay	n. 粘土,泥土
municipal	adj. 市的,市政的 n. 政府证券
clone	n. 克隆，无性繁殖，复制品 v. 克隆，复制
confer	vi. 商讨 vt. 赠予,授予
pond	n. 池塘 vt. 堵河成湖 vi. 形成池塘
exclusion	n. 排除,除外,逐出
lyric	adj. 抒情的 n. 抒情诗
technically	adv. 技术上, 学术上, 专门地
flourish	vi. 繁荣,茂盛,活跃,手舞足蹈 vt. 挥舞 n. 挥舞,华丽词藻,茂盛,兴旺,炫耀
upcoming	adj. 即将来临的, 预定将要
electron	n. 电子
thermal	adj. 热的,热量的,保热的 n. 上升的热气流
mediate	adj. 居间的,间接的 vt.& vi. 斡旋,调停
whatsoever	adv. (用于否定句中以加强语气)任何 pron.&amp;adj. 无论什么
novice	n. 新手,初学者
syntax	n. 句法
domination	n. 支配, 控制, 管辖 （复数）dominations:[宗]主天使
tile	n. 砖瓦 vt. 铺以瓦,铺以瓷砖
ballet	n. 芭蕾舞
noble	adj. 高尚的, 宏伟的, 贵族的, 高贵的 n. 贵族
banker	n. 银行家
transcription	n. 抄写，誊写，录音，编曲 [生]转移
differentiate	vt. 识别, 使差异, 求导数, 区分, 区别对待 vi. 区别,变异
sailor	n. 海员, 水手，扁平的硬边草帽
rehabilitation	n.复原
prose	adj. 散文的 n. 散文
dwell	vi. 居住, 存在, 冥想, 详细阐述
reactive	adj. 反动的, 反应性的, 反冲的
audio	adj. 成音频率的,声音的 n. 音响设备
wholly	adv. 完全地，一概
optimal	adj. 最佳的, 最理想的
presently	adv. adv. 不久, 一会儿, 现在, 目前
lid	n. 盖
alike	adj. 相似的,同样的 adv. 一样,以同样的方式
scarce	adj. 缺乏的,不足的,稀少的,罕见的 adv. 勉强
forum	n. 论坛, 讨论会
unprecedented	adj. 空前的,前所未有的
fringe	n. 流苏,次要,（地区或群体）边缘,（沿…边缘的）一排（树木、房屋等）vt. 用流苏修饰,镶边
drought	n. 干旱
inadequate	adj. 不充分的,不适当的
validity	n. 有效性,正确性,正当
biology	n. 生物学
vein	n. 静脉,纹路,岩脉,情绪,风格,气质 vt. 饰以纹路
toe	n. 脚趾,足尖 vt. 趾触,趾踢 vi. 踮着脚尖走
trauma	n. 精神创伤,外伤
trans	n. 会报(论文，传导，变压器，翻译，译员)
unpleasant	adj. 使人不愉快的, 讨厌的
connotation	n. 隐含意义，某事的重要性
unusually	adv. 异乎寻常地(显著地,非常)
affordable	adj. 支付得起的, 不太昂贵的
halfway	adj. 中途的, 不彻底的 adv. 半路地, 在中途
nonlinear	adj. 非线性的
amino	adj. 氨基的 pref. 表示“氨基”
photography	n. 摄影术
atom	n. 原子
semester	n. 学期
penetration	n. 渗透,侵入,突破,
notation	n. 记号法,表示法,注释 [计算机] 记法
mobility	n. 可动性, 变动性, 情感不定
elasticity	n. 弹力, 弹性
reside	v. 住,居留,属于
converge	vi. 聚合,集中于一点 vt. 使集合
creativity	n. 创造力, 创造
precipitate	vt. 使...陷入,促成,使...沉淀, 猛摔 n. 沉淀物, 冷凝物 adj. 仓促的, 迅猛的, 感情用事的
intact	adj. 尚未被人碰过的,原封不动的,完整的, 完好无缺的
newcomer	n. 新来的人, 新手
volatile	adj. 反复无常的, 挥发性的, 稍纵即逝的, 脾气火爆的 n. 挥发性物质
binary	adj. 二进位的,二元的 n. 二进制,二元
surgical	adj. 外科的, 外科医生的, 手术上的
viewpoint	n. 观点, 看法
beautifully	adv. 美丽地, 漂亮地
magnetic	adj. 有磁性的,有吸引力的,催眠术的
magnificent	adj. 壮丽的,宏伟的,极好的
momentum	n. 动力,要素, 势头,（物理）动量
mainland	n. 大陆, 本土
persistent	adj. 固执的,坚持的,连续的
vitamin	n. 维生素
copper	adj. (紫)铜色的,铜(制)的 n. 铜,铜币,铜制品
colonial	adj. 殖民地的 n. 殖民地居民
radar	n. 雷达
quantitative	adj. 数量的,定量的
cord	n. 绳索,束缚 vt. 用绳索绑
enormously	adj. 巨大的,庞大的 adv. 巨大地
qualitative	adj. 性质上的, 质的, 定性的
differential	adj. 微分的；差别的；特异的 n. 微分；差别差额
overview	n. 概观(况),总结 [计算机] 概貌
synthesis	n. 合成,综合,推理
rewrite	n. 重写, 改写 vt. 改写, 重写 vi. 修改
ration	n. 定额,定量,配给 vt. 限量供应
insufficient	adj. 不足的
partition	n. 分割,隔离物,隔墙 v. 区分,隔开,分割
compensate	vt. &vi. 偿还,补偿,付报酬
recount	vt. 详述,列举,重新计算 n. 重新计算
educator	n. 教育家，教育工作者
enzyme	n. 酶
ray	n. 光线, 射线, 雷(男子名)
breakthrough	n. 突破
relaxation	n. 松弛,放松,减轻
plantation	n. 种植园，大农场，殖民地
dioxide	n. 二氧化物
romance	n. 冒险故事, 浪漫史, 传奇文学
marine	n. (海军)士兵或军官, 海景画 adj. 海的,海事的,船舶的,航海的
realm	n. 王国,领域
resent	v. 愤恨,憎恶,怨恨
indigenous	adj. 该土地所固有的,土著的,国产的
simulate	v. 假装,冒充,模仿,模拟
thickness	n. 厚度, 一层, 含混不清
cooperative	adj. 合作的,共同的 n. 合作社
helix	n. 螺旋，螺旋状物，耳轮
goodness	n. 善良, 美德，精华 int. 天哪
recorder	n. 记录员，记录器（录音机等） n. （英国某些市镇的）首席法官，市法院法官 n. 竖笛
incumbent	adj. 凭依的, 依靠的, 负有义务的 n. 领圣职的俸禄的牧师, 在职者
trait	n. 特征,特点,特性,品质
spontaneous	adj. 自发的, 自然产生的
resentment	n. 怨恨, 愤恨
coordination	n. 同等,调和
intensive	adj. 强烈的, 密集的, 精细的, 强调的 n. (语法)强调成份
inland	adj. 内陆的, 国内的 adv. 内陆地 n. 内陆
replication	n. 复制
restoration	n. 恢复, 归还, 复位
vulnerability	n.弱点,攻击
inspiration	n. 灵感,吸入,鼓舞人心(的东西)
grammatical	adj. 语法的, 合乎文法的
damp	n. 毒气,湿气,丧气 adj. 潮湿的 vt. 呛,抑制,使潮湿 vi. 衰减
gravity	n. 地心引力,重力,严重,庄重,严肃
stereotype	n. 铅版,陈腔滥调,老一套 vt. 使用铅版,套用老套
widen	vt. 弄宽
pardon	n. 原谅,赦免 vt. 宽恕,原谅
darling	n. 亲爱的, 可爱的人, 可爱的物 adj. 可爱的, 亲爱的
seemingly	adv. 表面上(看上去)
invariably	adv. 不变化地, 一定不变地, 常常地
grind	n. 磨, 碾, 挤摩擦声, 无聊的苦工作 vt. 磨, 碾, 挤压, 摇动手柄 vi. 磨擦, 磨碎, 用功
constituency	n. 选区
canal	n. 运河,沟渠,气管,食管 vt. 建运河,疏导
warfare	n. 战争,冲突
shaft	n. 轴,杆状物 vt. 装杆于,利用
wireless	adj. 无线的 n. 无线电,收音机 v. 用无线电发送(通讯)
courtyard	n. 庭院, 院子
hurricane	n. 飓风,飓风般猛烈的东西 adj. 有防风罩的
multinational	adj. 多国的, 多种国籍的 n. 多国籍公司, 跨国公司
interference	n. 冲突, 干涉 [计算机] 干涉
remarkably	adv. 显著地, 引人注目地, 非常地
reminder	n. 提醒的人,催函
thirst	v. 渴望,渴求 vi. (for)渴望,渴求 vt.&amp;n. 渴,渴望
kidney	n. 肾,腰子,类型
utter	adj. 全然的,绝对,完全 vt. &vi. 发出,作声,发表
secular	n. 牧师,凡人 adj. 世俗的,现世的,不朽的
sediment	n. 沉淀物
leaflet	n. 小叶,传单 vt.& vi. 散发传单
documentation	n. 文件
dilute	vt. 冲淡,稀释 adj. 冲淡的,稀释的,微弱的
denominator	n. 分母,平均水平
subjective	adj. 主观的 n. 主格,主观事物
inversion	n. 倒转, 反向, 倒置
utilize	vt. 利用
reservoir	n. 水库,蓄水池,积蓄,储藏
thumb	n.拇指； （手套的）拇指部份 vi.翘起拇指请求搭乘（过路汽车），示意请求搭便车； 翻阅 vt.翻阅； 作搭车手势； 用拇指翻脏[翻坏]（书页等）
resistant	adj. 抵抗的,反抗的 n. 抵抗者
tiger	n. 老虎
perfume	n. 香水,香气 v. 洒香水于,薰香
affirm	vt. 证实,断言,肯定 vi. 断言,申明
ceramic	adj. 陶器的 n. 陶器, 陶瓷学
chunk	n. 厚块（片）, 相当大的量，矮胖的人或物 vt. （高尔夫球）没击中 vi. 发出猛冲的声音
legendary	adj. 传说的, 富有传奇色彩的, 传奇的
dissection	n. 解剖, 切开，剖析
cement	n. 水泥,纽带,接合剂,牙骨质,补牙物,基石 vt. 接合,用水泥涂 vi. 接合起来
divine	adj. 神的,神圣的 vt. 推断 vi. 预言,理解 n. 牧师,神学家
marketplace	n. 集会场所, 市场 商场
disruption	n. 分裂, 毁坏
spectator	n. 观众, 旁观者
shiny	adj. 有光泽的, 发光的, 辉煌的
demographic	人口统计学的 adj. 人口的,人口统计的
characterization	n. 描绘、刻画
anthropology	n. 人类学
butterfly	n. 蝴蝶,蝶状物,蝶泳 vt. (烹饪时把鱼肉等）切开摊平
parental	adj. 父母的
fertilizer	n. 肥料
straightforward	adj. 笔直的, 率直的
magical	adj. 魔术的，有魔力的，神奇的
chemist	n. 化学家, 药剂师
syllabus	n. 摘要,课程表
prone	adj. 俯卧的, 易于...的, 有...倾向的
directive	adj. 指导的, 指挥的, 管理的 n. 指令 [计算机] 指令
problematic	adj. 问题的, 有疑问的
successor	n. 接班人,继任人
reactor	n. 反应者，反应堆
manipulation	n. 操作，控制，窜改
equivalence	n. 相等, 等值
amplitude	n. 广阔, 充足, 增幅 n. 振幅、波幅(物理)
transparent	adj. 透明的, 明显的, 清晰的
detection	n. 察觉, 发觉, 侦查, 探测
annually	adv. 每年,年年 n. 每年
rotation	n. 旋转,循环
reconstruction	n. 复兴, 改造, 再建
micro	adj. 微小的 n. 微米(百万分之一, 测微计)
supervision	n. 监督, 管理
homeland	n. 祖国
turbulent	adj.骚乱的，混乱的； 激流的，湍流的； 吵闹的； 强横的
unity	n. 个体, 一致, 结合
neutral	adj. 中立的,中性的 n. 中立者,空挡的,素净色
terminology	n. 术语,术语学
terrace	n. 平台,阳台,梯田 v. 使成阶地,使成梯田 vt. 使成梯田
coastal	adj. 海岸的,沿海的,沿岸的
portable	adj. 轻便的,手提式的 n. 手提打字机
leaf	n. 树叶,页,活动桌板,花瓣 vt. 翻页 vi. 长叶子,翻页浏览
theorem	n. 定理
temporarily	adj. 临时的 adv. 暂时地,临时地
provincial	n. 乡下人, 地方人民 adj. 省的, 地方的, 偏狭的
sacred	adj. 神圣的,受尊重的
cliff	n. 悬崖, 峭壁
stiff	adj. 坚硬的,严厉的,呆板的,不灵活的 adv. 僵硬地,彻底地 n. 死尸, 过于拘谨的人, 流浪汉, 吝啬鬼, 醉鬼 vt. 诈骗,失信,不给小费
collar	n. 衣领,项圈 vt. 抓住,为...戴上项圈
bizarre	adj. 奇异的,怪诞的 n. 奇异花
humble	adj. 卑下的, 谦逊的, 粗陋的 vt. 使...卑下, 贬低
awesome	adj. 令人惊叹的，难得吓人的，很好的
compulsory	adj. 被强制的,强迫的,义务的
psychiatric	adj. 精神病的，治疗精神病的
presume	vt. 姑且认定，假定，推测，认为是理所当然 vi. 假设，越权行事
commentary	n. 实况报道，现场解说,评论,注释，批评
fling	n. 投掷, 一时的行乐, 漫不经心的一段(尝试或感情) vt. 投, 粗暴地推向..., 猛冲, 激动地说, 全身心投入 vi. 急冲, (动物)猛跳
fluctuation	n. 波动,起伏
susceptible	n. 易受影响者,易受感染者 adj. 易受影响的,易感动的,容许
lever	n. 杠杆,似杠杆之工具 vt. 撬开,使用杠杆
liable	adj. 有义务的,应负责的,有...倾向
satisfactory	adj. 令人满意的
trivial	adj. 琐碎的, 不重要的
archaeological	adj.考古学的,考古学上的
marrow	n. 骨髓, 精华, 活力 n. 西葫芦
found	vt. 创立，建立；创办 v. 找到（find的过去分词）
undergraduate	n. 大学生 adj. 大学部的
immense	adj. 巨大的,广大的,非常好的
toxic	adj. 有毒的 n. 有毒物质
unlimited	adj. 无限的, 不受控制的, 无条件的
sexuality	n. 性别, 性方面的事情, 性欲
neural	adj. 神经的
triple	n. 三倍之数,三个一组 adj. 三倍的
scrape	n. 刮掉,擦掉,刮擦声 vt.& vi. 刮掉,擦掉
ideally	adv. 理想地, 完美地，观念上地
drown	vt. 淹死,沉浸于, vi. 淹死
conceive	vt. &vi. 构思,以为,怀孕
generalize	v. 使一般化, 概括，归纳
brace	n. 支柱,曲柄,大括号 vt. 绷紧,顶住,（为困难或坏事）做准备,使更为坚固 vi. 振作精神,做好准备
succession	n. 连续, 继承权, 继位
outsider	n. 外行, 旁观者, 局外人
periodic	adj. 周期的, 定期的，间歇的，完句的
membrane	n. 薄膜,膜皮,羊皮纸
trajectory	n. 轨道,弹道,轨线
broadly	adv. 宽广地, 明白地, 概括地 adv. 无礼貌地
earthquake	n. 地震
furnish	vt. 布置,提供,装备
sunset	n. 日落，衰落时期（尤指人的晚年）
continuity	n. 连续性
locally	adv. 地方性地, 局部性地, 位置上
pillar	n. 柱子,支柱,核心(人物) vt. 用柱支持
hunter	n. 猎人，猎犬，猎马，搜寻者 Hunter: 亨特（姓氏）
wedge	n. 楔子,楔形物 vt. 楔住,嵌,挤进 vi. 被卡住
conquer	vt. 征服, 战胜, 克服 vi. 得胜
gauge	n. 测量标准,轨距,口径,直径,测量仪器 vt. 测量,估计,判断
minimal	adj. 最低限度的,最小的
banana	n. 香蕉
vase	n. 花瓶
rationality	n. 理性，合理性 （复数）rationalities:合理的意见（信仰、行为等）
invert	v. 使反向;使倒置
cling	n. 紧抓,紧贴 vi. 粘紧,附着,紧贴
jewelry	n. 珠宝, 珠宝类
hostile	adj. 怀敌意的,敌对的
distract	vt. 转移,分心
emergence	n. 出现
acute	adj.尖的，锐的； 敏锐的，敏感的； 严重的，剧烈的； [医]急性的, 激烈的, 尖锐的
herb	n. 药草, 香草
overhead	n. 经常开支,普通用费 adj. 在头上的,高架的 adv. 在头顶上,在空中,在高处 [计算机] 总开销
encode	vt. 编码, 译码
prospective	adj. 未来的, 预期的
philosophical	adj. 哲学的, 冷静的, 哲学上的
prototype	n. 原型,雏形
cooperate	vi. 合作,协力
proximity	n. 接近,亲近
coefficient	n. 系数
nonetheless	adv. 尽管如此(仍然) conj. 尽管如此(仍然)
orbit	n.势力范围, 眼眶, 轨迹 vt. 绕轨道而行, 进入轨道 vi. 盘旋
costly	adj. 昂贵的，代价高的
incorrect	adj. 不正确的, 错误的
contour	n. 轮廓(等高线,周线,电路,概要) vt. 画轮廓(画等高线) adj. 显示轮廓的
railroad	n. 铁路 =railway（英） vt. 由铁道运输，使（议案等）草草通过 vi. 在铁路公司工作
bodily	adj. 身体的，肉体的，具体的 adv. 全部地，活生生地，亲身地
contradictory	adj. 反驳的,反对的,抗辩的 n. 正反对,矛盾对立
glimpse	n. 一瞥,一闪 vt. &vi. 一瞥, 闪烁
globe	n. 地球, 地球仪, 球体
critique	n. 批评,批评法,评论
illusion	n. 幻觉,错觉,错误的信仰(或观念)
phenomenal	adj. 现象的, 可感知的, 非凡的
skeleton	n. 骨架,纲要,骨骼,骨瘦如柴的人或动物,家丑 adj. 骨骼的
industrialize	v. (使)工业化 =industrialise(英)
equilibrium	n. 平衡,均衡
complement	n. 补语；余角；补足物；补体 vt. 补足，补助
pathway	n. 路, 径
infinite	adj. 无限的,无穷的 n. 无限
utterly	adv. 完全, 全然, 绝对
persist	vi. 坚持,固执,持续
weaken	v. 使...弱, 变弱, 弄淡
repay	v. 偿还,报答，还钱给
reproduction	n. 再现, 复制, 生殖，幼树
consolidate	v. 巩固,联合,统一 [计算机] 使固定
incidence	n. 发生(率),入射
discriminate	vt. 区分，区别对待 vi. 辨别，差别对待
induction	n. 就职,感应,归纳法,序言
wagon	n. 四轮马车,货车 vt.& vi. 用四轮马车运
overtime	n. 加班时间(加班加点费) adv. 在规定时间之外(超出时间地)
infinity	n. (时间,空间等)无限,无穷，[数]无穷大
syndrome	n. 综合征，综合症状；（不良情况的）典型表现，典型行为
presidency	n. 总统（总裁、主席等）的职位（或任期）
calculator	n. 计算器
instrumental	adj. 仪器的,器具的,可做为手段的
mechanical	adj. 机械的,力学的,呆板的 n.(供制版用的)样书, 版面设计
inequality	n. 不平等，不平均，差异，多变性，&lt;数&gt;不等式
parasite	n. 寄生虫,寄生生物，食客
deliberate	adj. 故意的,深思熟虑的, 从容不迫的 vi. 仔细考虑 vt. 研讨
greenhouse	n. 温室, 暖房
herbicide	n. 除草剂
irrigation	n. 灌溉
deadly	adj. 致命的, 致死的 adv. 非常地, 如死一般地
socially	adv. 在社会上, 在社交上, 亲切地
intensify	vt. 增强(强化,加剧,加厚,增高银影密度)
candle	n. 蜡烛
grid	n.格子，非实质的； 地图上的坐标方格； （输电线路、天然气管道等的）系统网络
canvas	n. 帆布，（帆布）画布，油画
symbolic	n. 代号 adj. 象征的, 符号的
renewal	n. 更新, 革新, 复兴, 复活
shrine	n. 圣地, 神龛, 庙 v. 将...置于神龛内，把...奉为神圣
repetition	n. 重复,反复
wolf	n. 狼
thrive	vi. 兴旺,繁荣
stressful	adj. 紧张的, 压力重的
tribal	adj. 部落的, 种族的
disguise	n. 假面目,伪装物,假装 vt. 假装,假扮,掩饰
seasonal	adj. 季节的, 依照季节的, 周期性的
arbitrary	adj. 任意的, 专制的, 武断的, 霸道的
disagreement	n. 不合, 争论, 不一致
juvenile	adj. 年轻的,青少年的,幼稚的 n. 青少年,青少年读物,幼雏,扮演少年的演员
substantive	adj. 独立的,真实的,持久的,本质的,名词性的,大量的,规定义务与责任的,实质的 n. 作名词用的词或词组
substrate	n. 基片(基层, 真晶格, 基质) n. 衬底
sneeze	n. 喷嚏 vi. 打喷嚏
displace	v. 移置, 替换
worthwhile	adj. 值得(做)的
diversify	v. 使成形形色色, 使多样化, 使变化
sodium	n. 钠
workforce	n. 劳动力, 工人总数, 职工总数