responsible	adj. 有责任的,负责的,责任重大的,应负责的
rest	n.休息； 剩余部分； 支持物； 宁静，安宁 vt.& vi.（使）休息； （使）倚靠[支撑] vi.休息； 静止； 停止； 安心 vt.使休息； 使轻松； 使长眠； 使依赖
desk	n. 书桌
monitor	n. 监督器, 班长, 监听员, [计算机]显示器, 监视器 v. 监视, 监听, 监督
fault	n. 故障,过失,缺点 vt.&vi. 挑剔,指责，发现错误, 断裂
century	n. 世纪，一百年，成百的东西
southern	adj.南方的，南部的； 来自南方的 n.南方人，南部人
yard	n. 庭院, 场地, 码
chain	n. 链,连锁,束缚 vt. 用铁练锁住,束缚,囚禁
tiny	adj. 极小的,微小的
yellow	adj. 黄色的 n. 黄色
chance	n. 机会, 意外, 运气, 风险 vi. 偶然发生 vt. 偶然发生, 冒险
unclear	adj. 不易了解的, 不清楚的, 含混的
key	adj. 主要的,关键的 n. 钥匙,关键,答案,按键,音调 vt. 上锁,调节,提供解答,键入 vi. 使用钥匙
channel	n. 通道,频道,海峡,方法 vt. 引导,开导,形成河道,输送
kick	n. 踢,冲刺,反冲,钱包,反对,极大兴趣 vt. 踢,对自己生气,戒除 vi. 踢,反抗,充满活力的运作,反冲,冲刺
picture	n. 图画,照片,景色 vt. 画,描写,想像
speaker	n. 说话者, 发言者, 说某种语言者, 扬声器
specific	adj. 特殊的, 明确的, 具有特效的 n. 特效药, 特性, 详情
healthy	adj. 健康的
assistance	n. 帮助, 援助
bedroom	n.卧室，寝室 adj.<美>城郊住宅区的； 两性关系的，男女性爱的
tourist	adj. 旅游的 n. 旅游者,观光者
file	n. 档案,公文箱,锉刀,[计算机] 文件 vt. 列队行进,归档,申请
fill	vt. 装满,填充,弥漫,担任 n. 足量
consequence	n. 结果,后果
director	n. 董事,经理,主管,指导者,导演
spot	n. 污点, 地点, 斑点; 职位 adj. 当场的, 现实买卖的 v. 使沾上污点, 认出, 用灯光照射
distance	n. 距离, 远方, 路程 vt. 与 ... 保持距离, 把(对手)甩在后面 adj. 远程(教育)的
spread	n. 传布, 伸展 adj. 扩延的 v. 传布, 推广, 伸出
wrong	adj. 错误的,不正当的,失常的 adv. 错误地 n. 错误,不公正 vt. 伤害,亏待,欺骗,中伤
disappoint	vt. &vi. 使...失望
environmental	adj. 环境的
carefully	adv. 小心地, 仔细地
hide	vt.隐藏； 躲避，隐匿，躲藏； 遮蔽，覆盖 vi.隐瞒； 遮住； 遮挡； 掩盖 n.兽皮； <口>生命； <口>人的皮肤； （观看野生动物的）隐蔽处
anymore	adv.(用于否定句中)不再
yeah	adv. 是
disk	n. 圆盘,唱片,花盘,盘形物,光盘 vt. 用圆盘耙耙地 [计算机] 磁盘
wind	n. 风,气流,风向,管乐器,动向,潮流,空想, 卷绕,一圈 vt. 上发条,缠绕,蜿蜒,使...喘气,使...通风,吹奏 vi. 卷曲, 吹响号角, 迂回
necessary	adj. 必需的,必要的,必然的 n. [pl.]必需品
treat	v. 对待, 治疗，处理，请客，视为 n. 款待，宴飨
route	n. 航线,路线,途径 vt. 按路线发送, 改变路线
tree	n. 树
particularly	adv. 特别, 尤其
pool	n. 水塘(池),游泳池,撞球 vi. 形成池塘 vt. 集中,积累
pop	n. 取出,砰然声,流行乐曲,流行文化艺术,（尤用作称呼）爸 adj. 流行的,热门的,通俗的 vt. 取出,发出爆裂声,突然伸出,击打,开火 vi. 发出砰的一声，（因激动、惊奇）张大 adv. 突然间地, 暴发地 POP abbr.=point of purchase POP abbr.=population 人口
assessment	n. 估价, 评估
celebrate	vt. &vi. 庆祝,祝贺,颂扬
nice	adj. 美好的,令人愉快的,漂亮的,善意的
possibility	n. 可能性,可能的事情,潜在的价值
horse	n. 马 vt. 骑马 adj. 马的
acid	adj. 酸的 n. 酸, 酸味物质
corporation	n. 公司, 法人, 集团
potential	adj.潜在的，有可能的； [语法学]可能语气的，表示可能性的； 有能力的 n.潜力，潜能； [物]电位，势能； 潜能的事物； [语]可能语气
coffee	n. 咖啡
left	adj.左边的，左侧的； 左派的 n.左，左面； [军]左翼； 左派，激进分子 adv.向左； 在左边 v.离开( leave的过去式和过去分词)
cold	adj. 冷的, 漠然的, 客观的 n. 感冒, 低温 adv. 唐突地, 无回旋余地地, 即兴地
legal	adj. 法律的,合法的,法定的
colleague	n. 同事
none	pron.没有人，没有一人； 没有一个； 没有一部分，没有一点 adv.根本不； 无法，绝不
transaction	n. 交易,处理,办理
afternoon	n. 下午 int.下午好
preparation	n. 准备
effectively	adv. 事实上,有效地
stress	n. 紧张, 压力 v. 强调, 着重 vt. 强调 n.负载
alone	adj. 单独的,仅仅，独自一人的 adv. 只有,独自地, 独一无二地
characteristic	adj. 特有的, 典型的 n. 特性, 特征, 特色
schedule	n. 时间表, 一览表, 计划 vt. 安排, 计划, 预定, 编制目录
comfort	n. 舒适,安慰,安慰者 vt. 安慰
unique	adj. 独一无二的, 独特的, 稀罕的
comment	n. 注释, 评论; 闲话 v. 注释, 评论
limit	n.限制； 限量，限度； 界限 vt.限制，限定
framework	n. 结构, 框架, 参照标准, 体系
impose	vi. 利用；欺骗；施加影响 vt. 强加；征税；以…欺骗
animal	n.动物，兽，牲畜； <俚>家畜，牲口； <俚>畜生（一般的人）； 兽性 adj.动物的； 肉体的； 肉欲的
input	n. 输入
birthday	n. 生日
freeze	v. 冻结, 冷冻, 僵硬 [计算机] 冻结
submit	vt. 呈送, 递交, 主张 vt. 使服从, 屈服 vi. 屈从; 忍受
substantial	n. 重要部份, 本质 adj. 大量的, 实质上的, 有内容的
birth	n. 出身, 血统, 出生, 诞生, 出现, 起源
compete	v. 竞争, 对抗
literature	n. 文学, 文献
approve	vt. 批准,核准,证实 vi. 赞同
nurse	n. 护士,保姆,奶妈 vi. 看护,照顾,栽培,当看护 vt. 哺乳,看护
secure	adj.安全的； 牢固的； 有把握的； 安心的 vt.保护； （使）获得； 使安全； 担保 vi.获得安全，变得安全； 安全，保险； 承保，担保； [航海学]停止工作
project	n. 工程,项目,计划,事业 v. 计划,设计,表达 v. 投射,放映,凸出
duty	n.税，义务, 职责 adj. 值班的, 作为一种义务的
unusual	adj. 不平常的, 异常的
arrangement	n. 安排,商议,整理
tool	n. 工具,用具,受人利用的人,印压的图案 vt. 驾驶,用工具加工,印压图案于 vi. 驾驶,用工具加工
season	n. 季节,时期,旺季，上演期 vt. 加调味料调味,使...适用于 vi. 使…被调味，
sum	n. 总数(计),金额,顶点,概略,一笔钱 vt. 总计,概括 vi. 总计
folk	n.民族； 人们； 〈口〉家属，亲戚； 民间音乐 adj.民间的； 普通平民的； 流传民间的； 普通百姓的
apparently	adj. 显然,似乎 adv. 显然
select	adj. 精选的 n. 被挑选出来的人或物 v. 选择 vi. 选择,挑选,选拔 vt. 选择,挑选
selection	n. 选择,挑选,挑选出来的人或事
protect	vt. 保护,投保 vi. 提供保护
urge	n. 冲动 vt. 驱策,鼓励,力陈,催促 vi. 极力主张
east	adj. 东方的 adv. 向东方 n. 东, 东方
furniture	n. 家具
attractive	adj. 有吸引力的, 引起注意的
gain	n. 增益, 获得, 利润 vt. 得到, 增进, 获利 vi. 增加, 得到, (钟, 表等)走得快
bomb	n. 炸弹,高压罐,火山口喷出的熔岩 vt. 轰炸,大败,长传 vi. 失败
user	n. 用户, 使用者
technical	adj. 工艺的, 技术的
pull	n. 拉,拖,拉绳,影响 vi. 拔,拉,拖,扳动 vt. 拉,拔
complain	vi. 抱怨,悲叹,控诉
occur	vi.发生； 出现； 闪现
valuable	adj. 贵重的, 有价值的 n. (pl.)贵重物品
serious	adj.严肃的, 庄重的, 严重的, 危急的, 认真的
install	v. 安装,安置,使...就职 n.[计算机] 安装,DOS命令 : 装入结束且驻留软件
variety	n. 多样, 种类, 杂耍
elect	n. 当选人, 被选的人, 上帝的选民 adj. 被选的, 选出的 v. 选举, 选择
vary	vt. 改变,使多样化 vi. 变化,违背
sweep	vt. 扫除,拂去,掠过,席卷,扫视,全胜 vi. 打扫,席卷,昂首阔步地走,连绵,全胜 n. 扫除,席卷,搜寻,挥动,范围,风帆,(竞赛中)全胜,连绵一片,赌金
push	n. 推,奋力,决心 vt. &vi. 推,挤,逼迫
instance	n.例子，实例； 情况； 要求，建议； [法]诉讼手续 vt.举…为例
complicate	vt. 弄复杂, 使错综, 使起纠纷
priority	n. 优先权, 优先顺序, 优先
via	prep. 经由
fee	n. 费用,封地
machine	n.机器，机械； 机械般的人； 核心 vt.用机器制造，用机器加工 vi.被机器切削
convince	vt. 说服, 使...相信
opposite	adj. 相对的, 相反的, 对面的 n. 对立物，对立者，对手 adv. 在对面地，处于相反位置地 prep. 在...对面
corner	n.角落，角； 拐角； 困境； [商]囤积 vi.驾车转弯； 聚于角落 vt.垄断； 逼入困境 adj.位于角落的
agent	n. 代理人，代理商；药剂；特工；动力 vt. 由…作中介；由…代理 adj. 代理的
dad	n. 爸爸
inch	n. 英寸 v. 慢慢前进,慢慢移动
income	n. 收入,所得
shoot	n. 射击,芽,发射 vt. 射击,发出,发芽 vi. 飞驰
brother	n. 兄弟, 同胞, 同事, 教友
brown	adj. 褐色的,棕色的 n. 褐色,棕色 (姓)布朗
court	n. 法院, 庭院, 奉承, 球场 v. 献殷勤, 追求, 招致（危险、失败等）
warm	adj. 暖和的,快要发现的,热心的,新鲜的 vt. &vi.(使)变暖，（使）变得更友好, 加温 adv. 温暖地
shoulder	n. 肩膀, 角度, 交接处 vt. 肩负,承担,用肩推挤 vi. 用肩推挤
properly	adv. 适当地, 相当地, 当然地
equivalent	adj. 等价的, 相等的 n. 相等物
era	n. 纪元, 时代, 年代
influence	vt. 影响, 感化 n. 影响力, 势力; 影响, 权势 n. 有影响的人(或事物)
peer	vi. 凝视，盯着看；窥视 vt. 封为贵族；与…同等 n. 贵族；同等的人
blood	n. 血,血统,仇恨 vt. 流血
crew	n. 全体船员, 全体乘务员 vi. 一起工作
manufacture	n. 产品,制造,制造业 vt. 制造,加工 vi. 参与制造
critical	adj.批评的，爱挑剔的； 危险的，危急的； 决定性的； [物]临界的
concentration	n. 集中, 专心, 浓度
reality	n. 现实,实际,真实
cross	n. 十字架,十字架形物件,交叉,交叉路 adj. 生气的,交叉的 vt. 划叉剔除，画横线于 vi. 穿越 prep. 穿过
net	n. 网,净利,实价 adj. 净余的,纯粹的 vt. 用网捕,撒网,净赚
cast	n. 演员阵容, 投掷 v. 投, 掷, 抛
insist	vt. 坚持,强调 vi. 坚决主张
lady	n. 夫人, 女士
annual	adj. 每年的,年度的,一年生的 n. 年刊,年鉴,一年生植物
everywhere	adv. 到处, 无论何处
recognize	vt. 认出,认可,承认,意识到,表示感激
recommendation	n. 推荐, 介绍
examination	n. 考查,考试,审讯
mathematics	n. 数学
apparent	adj. 显然的；表面上的；似乎真实的
suppose	vt.假定； 猜想，推测； 认为； 让（用于祈祷语气） vi.想象，猜想
volume	n. 体积, 容量, 音量 n. 卷, 册
current	n. (水、气、电)流, 趋势 adj. 流通的, 现在的, 最近的
refer	vt. 把…提交; 把...归因, 归类为 vi. 谈及, 咨询, 参考
ten	num. 十, 十个
exchange	n. 交换,交换物,汇兑,交易所 vt. &vi. 交换,交易,兑换
graduate	vt. 毕业;(在表、计、尺上)刻[分]度,定等级 vi. 毕业,获学位,逐渐变得 n. 毕业生 adj. 毕业的,获得学位的
apply	vt. 应用, 申请; 涂 vt. 使专心从事 vi.申请; 有关联
attempt	vt.试图； 尝试 n.进攻； 尝试，冲击
cable	n. 电缆,海底电报 vt. 打海底电报,把...拧成缆,用缆捆住 vi. 打海底电报
paint	n. 油漆,颜料,绘画作品 vt. &vi. 油漆,绘画
restrict	v. 限制,约束
region	n. 地区,地域,地带,行政区
exist	v. 存在
regulation	n. 规则, 规章, 管理 adj. 规定的, 官方的
expense	n. 消费,支出
memory	n. 记忆,内存,回忆
slow	adj. 慢的 adv. 慢慢地 vt.& vi. 放慢,减速
mental	adj. 精神的,脑力的,精神错乱的,传心术的,[解剖学]颏的
cancer	n. 癌,巨蟹座
religion	n. 宗教;宗教信仰
growth	n. 生长, 增长, 生长物
guarantee	n. 保证(书), 担保(书) n. 担保人; 抵押品 vt. 保证, 担保
debt	n. 债务, 义务, 负债状态, 罪, 过失
decade	n. 十年
declare	vt. &vi. 宣布,声明,申报
pattern	n. 图案, 式样, 典范 v. 以图案装饰; 仿造, 模仿
factory	n. 工厂, 制造场所
milk	n. 奶, 乳状物 v. 挤乳, 产乳
associate	vt.（使）发生联系； （使）联合； 结交； 联想 vi.联盟； 陪伴同事 n.合伙人； 伴侣，同志； 非正式会员 adj.联合的； 合伙的； 非正式的； （性质上）有密切联系的
define	vt. 定义, 解释
reporter	n. 记者
society	n. 社会, 社团，阶层圈子
usually	adv. 通常
delight	n. 快乐,高兴 vi. 给与乐趣,使高兴 vt. 使高兴
requirement	n. 要求,必要条件
solid	adj. 固体的,结实的,可靠的,实心的 n. 固体,实心
deny	vt. 否认, 拒绝, 反对, 克制
depend	vi. 依靠,相信,指望
mobile	adj. 可移动的,易变的,迁徙的, 流动的 n. (可随风飘动的)悬挂装置, 可动雕塑
respectively	adv. 各自地, 分别地
deserve	vi. 应该得到 vt. 应受,值得
fast	adj.快的； 走得快； 感光快的； 紧的 adv.（比准确的时间或宣布的时间）快； 迅速地； 紧紧地； 彻底地 vi.禁食，（尤指）斋戒 n.禁食期，斋戒期； 断食，节食
title	n. 头衔,名称,标题,所有权,资格,冠军 vt. 赋予称号,加标题于 adj. 标题的
source	n. 来源
certainly	adv. 当然
motion	n.运动； 手势； 动机，意向； 请求 vt.打手势； 向某人点头或摇头示意； 打手势要求[指示] vi.运动； 打手势
pick	n. 采摘, 精选,鹤嘴锄,精品, 收获量 vt. 摘,挑选,挑惕,剔除,戳,撬 vi. 慎选, 凿, 吹毛求疵, 采收
revolution	n. 革命, 旋转, 转数
dollar	n. 美元
rich	adj. 富有的,浓厚的,贵重的,富饶的
movement	n. 活动,运动,动作,移动
female	adj. 雌的,女(性)的 n. 雌性的动植物,女子
notice	n. 注意,布告,通知 vt. 注意,通知,留心
pilot	n. 飞行员,领航员,引航员 vt. 领航,驾驶,向导 adj. 引导的,示范的
identity	n. 身份,一致，特征
reply	vt. &vi. &n. 回答,答复
sequence	n. 序列, 一系列, 顺序, 一组镜头 vt. 安排顺序
heavily	adv. 很重地, 沉重地, 沉闷地
heavy	adj.重的，沉重的； 大量的，浓密的； 激烈的； 重型的 n.重物； 庄重的角色 adv.密集地； 大量地； 笨重地
fight	n. 打架,战斗,斗志 vt. 对抗,打架 vi. 斗争,奋斗
hell	n. 地狱
river	n. 江, 河
myself	pron. 我自己
approximately	adv.近似地,大约
lack	vt.缺乏，缺少； 需要的东西 n.缺乏，不足，没有； 缺少的东西
final	adj. 最后的 决定了的 n. 决赛,期末考试
enterprise	n. 企业,企划,进取心
entertainment	n. 娱乐
nation	n. 国家, 民族
church	n. 教堂,礼拜仪式,基督教徒 adj. 教堂的 vt. 把...带到教堂接受某种宗教仪式
enable	vt. 使...能够,使可行 [计算机] 使能
presence	n. 出席,在场者,举止
plenty	n. 充足,大量
hi	int. 嗨, 引人注意时的喊声, 打招呼
root	n. 根,根源,祖先 vt. &vi. 生根,扎根,翻寻,起源于
stage	n. 阶段,舞台,驿站 v. 上演,表演,乘驿车旅行
false	adj. 不真实的,错误的,人造的,假的,虚伪的 adv. 不真诚地,虚伪地
reward	n. 报酬,报答,赏金 vt. 给...报酬,奖赏
fit	adj. 适宜的,对的,准备好的 v. 适合,安装 n. 适宜,发作,一阵
police	adj. 警察的 n. 警察,警方 v. 管辖
distinction	n. 区别; 卓越; 殊荣
standard	n.标准，规格； 旗，军旗； 度量衡标准； 直立支柱 adj.标准的，合格的； 普遍的，一般的； 公认为优秀的
politician	n. 政治家, 政客
proceed	vi. 继续进行; 开始, 着手
hole	n. 孔,洞,穴 vt. &vi. 挖洞,掘坑,进洞
holiday	n. 假期,假日 vi. 度假
trouble	n. 困扰,麻烦,困难,故障 vt.& vi. 困扰,麻烦
truck	n. 卡车,对...进行交易,来往,实物工资 vt.对...进行交易,交往,以卡车运输 vi.驾驶卡车,以物易物
status	n. 地位, 身份, 情形, 状况
accept	vi.承认； 同意； 承兑 vt.接受； 承认； 承担； 承兑
email	n.电子信函
nineteen	十九
intention	n. 意图,意向,目的
post	n. 邮件, 标竿, 职位 vt. 邮递, 发布, 布置
coast	n. 海岸,海滨,滑坡 vt. 沿海岸而行 vi. 下滑
coat	n. 外套,一层,动物皮毛 vt. 外面覆盖,盖上毛衣
doctor	n. 医生,博士 vt. 医治,篡改,对...做手脚 vi. 用药
code	n. 码,密码,法规,准则 vt. 把...编码,制成法典
sector	n. 扇形,扇区,部门,区域 vt. 分区
football	n. 足球 n. 橄榄球
troop	n. 群,组,军队,大量,童子军 vi. 群集,结队,成群前行,陪伴
column	n.纵队，列； 圆柱； 专栏
combination	n. 结合,联合，联合体
nor	conj.&adv. 也不,也没有 [计]"或非"，"非或" abbr. 诺曼人(=Norman) abbr. 北方（=North） abbr. 挪威（= Norway） abbr. 挪威人（=Norwegian）
storm	n. 暴风雨 v. 猛攻,捣毁,起风暴 vi. 起风暴,强攻 vt. 猛攻,捣毁
nose	n. 鼻子, 突出部分, 嗅觉 v. 嗅，嗅到
foreign	adj. 外国的,外交的,不相关的
typical	adj. 典型的, 有代表性的
strange	adj. 陌生的, 奇怪的
library	n. 图书馆, 藏书
station	n. 车(站),位置,姿势,地位 vt. (配)安置
underlie	v. 位于...之下, 成为...的基础
forth	adv.向前，向前方； 露着的，往外的； [废语]出外，离家 prep.出自，从…离开
illustrate	vt. 举例说明,作图解 vi. 举例
dress	n. 女装,服装,连衣裙 vt. &vi. 穿著 adj. 正式的(衣服)
primary	n. 最主要者 adj. 主要的, 初期的, 根本的
essentially	adv. 本质上,本来
impact	n. 冲击(力), 冲突, 影响(力) vt. 挤入, 压紧; 撞击; 对...发生影响
print	n. 版,印刷物,印迹 vt. &vi. 印刷,出版,打印 adj. 印刷的
commit	v. 委托(托付), 犯罪, 作...事, 承诺 [计算机] 委托
unit	n. 单位, 单元
search	n. 搜寻, 探究 v. 搜寻, 探求, 调查
production	n. 生产,产品,产量,作品,成果
teacher	n. 教师
complaint	n. 抱怨
completely	adv. 完全地, 十分地, 全然
devote	vt. 投入于,献身
bag	n. 包,猎获物 vt. 鼓起,把...装入袋中,猎杀,占有 vi. 鼓起,宽松地下垂或悬吊
fruit	n. 水果 vt. &vi. 结果实
proof	adj. 防...的,耐...的,能防护 n. 校样,证据,证明 vt. 检验,给...做防护措施
contract	n. 合约, 婚约; 合同书 v.签合同； 缩小； 感染
block	n.块； 街区； <英>大楼，大厦； 障碍物，阻碍 vt.阻止； 阻塞； 限制
volunteer	n. 志愿者,自行生长的植物 adj. 志愿的,自行生长的(树等) vt. &vi. 自愿(做)
proposal	n. 求婚, 提议, 建议
dream	n. 梦, 理想 vt. &vi. 做梦, 想象
oil	n. 油,油画颜料,奉承话 vt. &vi. 涂油,溶化,加油
protein	adj. 蛋白质的 n. 蛋白质
breakfast	n. 早餐 vt. 吃早餐 vi. 提供早餐
publish	vt. 出版,发行,公开发表 vi. 出版,发行
honor	n. 荣誉,荣幸,贞洁,正直,信用 vt. 尊敬,授予荣誉,实践,兑现
surely	adv. 的确地, 安全地
education	n. 教育,培养
senior	n. 年长者,上司,毕业班学生 adj. 年长的,高级的,资深的
beautiful	adj.美丽的, 漂亮的
everyday	adj. 每天的,日常的 b.平常的日子
survey	n. 调查; 纵览, 视察, 测量 vt. 审视, 视察, 通盘考虑, 调查; 勘测 vi. 测量, 勘测
suspect	vt.猜疑（是）； 怀疑，不信任； 怀疑…有罪 n.嫌疑犯 vi.怀疑
generation	n. 代, 一代
cry	n. 叫,哭,喊,口号,叫卖声,普遍意见 vt. 大声叫喊,宣传,哭得... vi. 哭,叫,喊,强烈要求
mainly	adv. 主要地
gentleman	n. 绅士, 先生，有教养的人
consist	n. 组成 vi. 组成,存在,一致
brain	n.脑； 智慧； 聪明的人； （群体中）最聪明的人 vt.打破…的脑袋； 打…的头部
convention	n.会议； 全体与会者； 国际公约； 惯例，习俗，规矩
background	n. 背景,幕后,配音 vt. 提供背景
climb	vt. &vi. 攀登,上升,爬 n. 攀登(处)
contemporary	n. 同时代的人；同时期的东西 adj. 当代的；同时代的；属于同一时期的
content	n. 内容, 目录, 含量 adj. 满足的, 满意的 vt. 使...满足, 使...安心
bank	n. 银行,堤,岸 vt. 堆积 vi. 开户, 把...存入银行
seven	num. 七
bed	n. 床，河床，底层，基座 vt. 铺床，去睡觉，安置，发生性关系 vi. 铺床，去睡觉，铺层，躺平
additional	adj. 附加的, 另外的
severe	adj. 剧烈的, 严重的, 严峻的, 严厉的, 严格的
classic	n. 古典作品,杰作,第一流艺术家 adj. 第一流的,最优秀的,古典的
discover	vt.& vi.发现
adopt	v. 采用, 收养, 接受
client	n.顾客； 当事人； 诉讼委托人； [计算机]客户端
shall	aux. 应该；会；将要；必须
vision	n. 视觉,先见之明,光景,视力,眼力,幻想，影像 vt. 幻想
occasion	n. 场合,机会,理由 vt. 致使,惹起,引起
opinion	n. 看法,意见 v. 判断,意见,主张
coverage	n. 涉及范围(如保险范围或储备金额)，涂层，新闻覆盖率
wonder	n. 惊奇；奇迹；惊愕 vi. 怀疑；想知道；惊讶 vt. 怀疑；惊奇；对…感到惊讶 adj. 奇妙的；非凡的
engine	n. 发动机, 引擎, 机车, 火车头 vt. 装引擎
opposition	n. 反对,敌对,在野党
shoe	n. 鞋
increasingly	adv. 逐渐地, 渐增地
cool	adj. 凉的,凉快的,冷静的,冷色系的 adv. 冷静地 n. 凉快 vt. &vi. (使)变凉,(使)冷静
independent	adj. 独立的, 自主的，私立的，无偏见的 n. 独立派人士, 无党派者
indicate	v.指明, 表明, 显示, 象征, 指示
shot	n.射手，击球； 开枪，发射； 企图； 注射 adj.闪色的，颜色会变化的； 交织的； 渗透的； （俚语）坏透了的，筋疲力尽的 vt.射中，射击； 给…装弹； 注射； 抛出 vi.发射，射击； 突然出现 v.拍摄(shoot的过去式和过去分词)； 射杀； 开（枪或其他武器）； 打猎
childhood	n. 童年,幼年
competitive	adj. 竞争的, 比赛的
trace	n. 痕迹,踪迹,微量 vt. 追踪,找出根源,描绘 vi. 追踪
ratio	n. 比,比率
shut	adj. 关闭的,合拢的,围绕的 vt. 关上，防止进入，禁闭，合上，停止或中止 vi. 关闭，停止或中止 n. 关闭
evaluate	vt. 评估,评价
sight	n. 景观, 视力, 眼界 vt. 看见, 观看 vi. 瞄准
mark	n. 污迹, 标记, 分数, 烙印, 纪录 vt. 做标记于, 留意, 打分数, 留下污痕, 使...明显 vi. 做标志, 记分, 留下印记
intelligence	n. 理解力, 智力, 情报, 情报工作, 情报机关
weekend	n. 周末 vi. 过周末 adj. 周末的, 兼职的
trade	n. 贸易,商业,交易,行业,同行,手工艺,主顾,(复数)信风 vi. 做生意,购物,交换 vt. 用某物交换,做买卖 adj. 商业的,专业性的,同行的
technology	n. 技术,工艺(学)
retail	n. 零售 vt. 零售 adj. 零售的 adv. 以零售形式
silver	adj. 银色的,银的 n. 银,银币,银器 vt. 镀银,变成银白色
telephone	n.电话； 电话机； （电话机的）话筒； 受话器 vt.& vi.以电话传送（消息），给（某人）打电话； 用电话与（某人）交谈
welfare	n. 福利,社会保障,幸福 adj. 福利的
exactly	adj. 完全的 adv. 恰好地,正好地,正确地,精确地,正是
instruction	n. 说明,须知,指令,教学
examine	vt.检查，调查； 考试； 诊察； 审问 vi.检查； 调查
reduce	vt.换算； 约束； 使变为； 使变弱 vi.减少； 减轻体重； [生物学]（细胞）减数分裂； （液体）浓缩变稠
wheel	n. 轮子,周期,旋转运动 vi. 旋转,转动 vt. 推或拉车,传送,打圈,装以车轮
grade	n. 年级,成绩,分数,等级,级别 vt. 分级,记成绩
treatment	n. 治疗,疗法,处理
excite	v. 刺激, 使...兴奋, 激励
exclude	vt. 除外,排除,拒绝 [计算机] 排除
pain	n. 痛苦,疼痛,辛苦 vt. &vi. 使...痛苦,痛苦,疼
executive	n.总经理； 行政部门； [计算机]执行指令 adj.执行的； 管理的； 政府部门的
currency	n. 货币; 流通
internal	adj. 国内的, 内在的，身体内部的
regular	adj. 有规律的,有规则的,整齐的,正规的
injury	n. 受伤处,损害,伤害
expectation	n. 期待,期望 v. 期待,前程
slight	n. 轻蔑 adj. 轻微的,纤细的,脆弱的 vt. 轻视,忽略
park	n. 运动场,专业区,园区,公园,停车处 vt. 停车,放排放置于 vi. 停车
slip	vi.滑，滑脱； 犯过失，出错； （时间）不知不觉地过去； （健康状况等）变差 vt.使顺利滑动； 摆脱； 放松，松开 n.跌倒，失足； 纸条； 失误，口误； 事故 adj.滑动的； 可拆卸的； 打有活结的
database	n. 数据库
mention	vt.提到，说起； 提名表扬 n.提及
relief	n.宽慰，安心； 免除，减轻； 救援物资； 代班人
merely	adv. 仅仅,只不过
passenger	n. 乘客,旅客
extra	adj. 额外的 adv. 特别地 n. 额外的事物，另外收费的
method	n. 方法,办法,条理
gun	n. 枪, 炮
regime	n. 政权，政体；社会制度；管理体制
fail	vi. 衰退,失败,不及格 vt. 辜负,缺少,未能做 n. 不及格
recall	vt. 召回；回想起，记起；取消 n. 召回；回忆；撤消
neither	adj. 皆不,两者都不 int. 两者都不 conj. 既非,既不
minor	adj. 次要的, 较小的, 二流的, 未成年的 n. 未成年人, 辅修科目, [音乐]小调 vi. 辅修
air	n. 空气,旋律,气氛,态度 vt. &vi. 晾干,使通风,广播
soldier	n. 士兵, 军人
confuse	vt. 混乱,狼狈,困惑
deliver	vt.发表； 递送； 交付； 使分娩 vi.投递； 传送
delivery	n. 递送, 交付, 分娩
solution	n. 解答, 解决办法, 溶解, 溶液
resident	adj. 居住的 n. 居民,旅客
tie	n. 结,束缚,不分胜负,(领)带 vt. 系,约束,捆绑 vi. 打结,连结
performance	n.表演； 演技； 表现； 执行
absolutely	adv. 绝对地,完全地;独立地;确实地
nearby	adj. 附近的 adv. 在附近 prep. 在...附近
responsibility	n. 责任, 可信度，责任心
cell	n. 细胞, 电池, 小组, 小房间, 单人牢房, (蜂房的)巢室, 手机
cent	n. 分
fashion	n. 流行,风尚,时样,时装 v. 形成,造,作
destroy	vt. &vi. 破坏,毁坏 [计算机] 撤消
laugh	n. 笑(声),笑料,(复数)娱乐 vt.& vi. 笑
moral	adj. 道德(上)的,有道德的 n. 品行,寓意,道德
phenomenon	n. 现象, 非凡的人或事物
expansion	n. 扩大,膨胀,扩充
concert	n. 音乐会, 一致, 和谐 vt. 制定计划, 通过协商达成一致 vi. 合作
sorry	adj.对不起的； 无价值的，低等的； 遗憾的； 感到伤心的
feature	n. 特征, 容貌 vt. 以...为特色 vi. 起重要作用
regional	adj. 当地的,地区的,局部的,方言的
atmosphere	n. 大气, 气氛，空气, 格调, 情趣, 气压
chapter	n. 章,回,篇,牧师的例行会议,地方分会
tax	n. 税,租税,重负 v. 课以税,使...负重荷,斥责
chart	n. 图表 vt. 制成图表
cheap	adj. 便宜的,品质低的,虚伪的 adv. 便宜地
analyze	v. 分析,分解 vt. 分析
check	vt.检查，核对； 制止，抑制； 在…上打勾 vi.核实，查核； 中止； 打勾； [象棋]将一军 n.<美>支票； 制止，抑制； 检验，核对
urban	adj. 城市的
topic	n. 题目, 话题, 主题
restore	vt. 恢复,归还,翻新
multiple	adj. 许多,多种多样的 n. 倍数,并联
acknowledge	vt. 承认,公认,告知收到,表示感谢,注意到
museum	n. 博物馆
bet	n. 打赌,赌注,最大的可能 vi. 下注 vt. 打赌
risk	n.危险，冒险； 保险额； 被保险人或物 vt.冒…的危险； 使…冒风险（或面临危险）
entirely	adv. 完全地
direction	n. 方向,指导,用法说明,趋势
typically	adv. 代表性地, 作为特色地
military	adj.军事的；军用的；讨厌的；好战的 n.军人；军队；武装力量
finance	n. 财政, 资金 vt. 给...提供资金, 负担经费
comfortable	adj. 舒适的,充裕的
land	n. 陆地, 国土, 土地 v. 登陆, 登岸, 卸货
player	n. 比赛者, 演奏者，演员，播放器
episode	n. 插曲,插话,(作品的一段)情节,有趣的事件
phase	n. 相, 相位,时期,局面,阶段 v. 逐步执行,实行,按计划进行
naturally	adv. 自然地,天生地
herself	pron. 她自己
discuss	vt. 讨论
discussion	n. 讨论 v. 讨论,商议
circumstance	n. 环境,(复数)境况,事件,详情
hill	n. 小山, 小堆, 斜坡 vt. 堆起, 培土
latter	adj. 后面的,后者的 pron.&amp;n. 后者
symptom	n. 症状, 征兆
launch	n.&amp;v. 下水,发射,开始,升天,汽艇
series	n. 系列，连续
democracy	n. 民主,民主制,民主国家
session	n.开会，会议；（法庭的）开庭； 会期，学期； （进行某活动连续的）一段时间
clean	adj. 干净的, 正当的, 纯洁的, 完全的, 精准的, 空的 adv. 完全地 n. 清洁 vt. &vi. 打扫,清扫
trend	n. 趋势,倾向,方位 vi. 倾向,转向
nervous	adj. 紧张的,焦虑的,神经质的
layer	n.层，层次； 膜； [植]压条； 放置者，计划者 vt.把…分层堆放； 借助压条法； 生根繁殖； 将（头发）剪成不同层次 vi.形成或分成层次； [植]通过压条法而生根
struggle	n. 竞争,努力,奋斗 v. 努力,奋斗,挣扎
flow	vi.流； 垂； 流出； （谈话、文体等）流畅 n.流动； 滔滔不绝； 涨潮； 连贯 vt.使泛滥； 淹没； 排出
ability	n. 才能, 能力
positive	adj. 肯定的, 积极的, 绝对的 adj. 正面的, 正数的, 阳性的
frame	n. 框,结构,骨架 v. 构成，把...框起来，陷害 adj. 木结构的
deeply	adv. 深深地,强烈地，（颜色）浓浓地，（声音）低沉地
defense	n. 防卫, 防卫物, 辩护 vt. 防守
pour	n. 流出,倾泻,骤雨 vt. &vi. 倒,倾泻,蜂涌而来
addition	n. 增加,附加物,加,加法
practical	adj. 实际的,实用的,明智的 n. 实践考试
admit	vt.& vi.许可进入； 承认，供认 vt.允许； 确认 vi.承认； 允许
safety	n.安全； 安全性； 安全处所； 中卫 adj.保障安全的
hundred	n. 百,百个东西 adj. 百,百个
combine	n. 集团,联合收割机 v. 化合,结合,联合 vi. 结合,联合 vt. 使结合,使联合
prefer	vt.更喜欢； 提升，提拔； 给予（债权人）优先权； 提出（控告） vi.更喜欢，宁愿
draft	n. 草稿,草图,汇票，徵兵 vt. 起草,征兵,选秀 adj. 酝酿中的
death	n. 死,死亡，死神，毁灭
prepare	vt.准备； 预备（饭菜）； 配备； 使（自己）有准备 vt.& vi.筹备，进行各项准备工作； 做好思想准备； 作出，制订； 锻炼（身体等），训
beach	n. 海滩 v. 拖(船)上岸 vt. 使船冲上滩
ahead	adv. 向前地,将来地,占优势,提前
focus	n. 焦点, 焦距 v. 集中, 聚集, 使集中
formal	adj. 正式的,形式的,礼节上的,拘谨的 n. 正式(活动)
newspaper	n. 报纸，报社，新闻纸 v. 从事新闻工作
strike	n. 罢工, 打击, 殴打 v. 打, 撞, 罢工, 划燃
scheme	n. 方案, 计划, 阴谋 v. 计画, 设计, 体系, 结构, 图谋
sexual	adj. 性的，性欲的，有性的
structure	n. 结构,构造,建筑物 v. 构成,建立,建造
principle	n. 原则, 原理, 主义, 信念
scientist	n. 科学家
prison	n. 监狱 vt. 囚禁, 关入监狱
driver	n. 驾驶员, 司机
committee	n. 委员会
drug	n. 药,毒品 vt. 下药,使...服麻醉药 vi.吸毒
listen	v. 听，倾听 n. 听，倾听
unknown	adj. 未知的，不出名的
seat	n. 位子,所在地,中心 vi. 坐 vt. 使坐下,可容纳
unlikely	adj. 不大可能发生的,未必的,多半不可能的
progress	n. 进步, 发展, 前进 vi. 促进，进步, 进行
argue	vt. 争论,辩论,争吵,劝说,表明 vi. 提出理由,争论,辩论
argument	n. 辩论,争论,论点(据),理由
fully	adv. 十分地, 完全地, 全
odd	adj. 奇数的,古怪的,剩余的 . 奇数
promote	vt. 促进, 提升, 升迁; 发起; 促销
article	n. 文章,物品,条款,冠词 vt. 定契约
property	n. 财产; 性质; 道具
upper	adj. 上部的,地位较高的,上面的,北方的 n. 鞋帮,上牙,兴奋剂,令人愉快的经历
function	n. 功能, 函数, 重大聚会 vi. 运行, 起作用
prospect	n. 景色, 希望, 展望 v. 探勘, 寻找
funny	adj. 滑稽的,有趣的,莫名其妙的 n. 笑话,(the funny)滑稽戏
conclusion	n. 结论
construct	vt. 构造,绘制,建造,想出 n. 构想,建造物
attract	v. 吸引, 有吸引力
furthermore	adv. 而且, 此外
highlight	n. 加亮区,精彩部分, 最重要的细节或事件, 闪光点 vt. 加亮,强调, 使...显得重要, 照亮 [计算机] 醒目
encounter	n. 意外的相见,遭遇 vt. &vi. 遇到,偶然碰到,遭遇
confidence	n.信心； 信任； 秘密
supply	n. 补给,供给,供应，贮备 vt. 补给,供给,提供,提供足够以满足
bone	n. 骨,骨骼,核心 vt. 除去骨头,往衣服里加撑条,磨光表面 vi. 努力学习 adv. 非常地,极其地
edition	n. 版, 版本
border	n. 边缘 vt. 作...之疆界,加边
element	n. 成分,要素,元素,基本原理,(复数)恶劣天气
elderly	adj. 过了中年的, 稍老的
academic	n. 教学人员,学术人员 adj. 学院的,理论的,学术性的
battle	n. 战斗,争论 vt. &vi. 与...作战;与...斗争
bother	vt. 烦扰 vi. 烦扰,操心 n. 烦扰
bottle	n. 瓶子 vt.装瓶, 抑制
incorporate	vt.组成公司； 包含； 使混合； 使具体化 vi.包含； 吸收； 合并； 混合
accord	n. 一致,调和,协议，自愿 vi. (与)一致（accord with） vt.使一致，调解；给予，赠予
election	n. 选举
unemployment	n. 失业,失业人数
ball	n. 球, 舞会 v. (把...捏)成球状
electronic	adj.电子的； 电子操纵的； 用电子设备生产的； 用电子设备完成的
accuse	vt. 责备,控告
beat	n. 打,敲打声,拍子,独家报道,一会儿 vt. &vi. 打,打败
judgment	n. 裁判, 宣告, 该判决书
below	adv.在下面，到下面 prep.（表示位置）在…下面； （表示状态）在…掩饰之下； （表示比较）不及； 低于
producer	n. 生产者, 制片人
fifteen	num. 十五 pron. 十五(个, 只...) adj. 十五的，十五个的
video	adj. 录像的 n. 录像(机) vt. 制作...的录像
contrast	n.对比，对照； 差异； 对照物，对立面； [摄]反差
breath	n. 呼吸,气息,微风,迹象,精神,一种说话的声音
employ	vt. 使用, 雇用, 使忙于 n. 使用, 雇用
failure	n. 失败,失败的人或事
conversation	n. 会话,谈话
shake	n. 摇晃,震动,地震,颤抖(音),奶昔,短时间 vi. 摇晃,颤抖,跌跌撞撞,握手,发颤音 vt. 挥拳,摇晃,去除,动摇,排掉(灰尘),握手
affect	vt. 影响, 作用, 感动
copy	n.复制品； 一份； （报刊等的）稿件； 准备排印的书面材料 vt.& vi.复制； 抄写； 容许复制的 vt.模仿； 仿造…的样式或图案； 抄写； 复制
wed	v. 与...结婚,结婚 Wed abbr. 星期三(=Wednesday)
ensure	vt. 确定,保证,担保
indeed	adv. 的确, 真正地, 事实上
organization	n. 机构,组织 adj. 有组织的
origin	n. 起源,出身,开端
countryside	n. 乡下, 农村
otherwise	adv. 否则,不同地,在不同方面 pron. 其他 adj. 不同的
photo	n. 照片 vt. &vi. 拍照 adj. 摄影的
essay	n. 尝试,短文,论文 vt. 尝试
recruit	n. 招聘,新兵,新成员 vt.&vi. 恢复,补充,徵募
tea	n.茶.茶叶.茶树.茶点 vt.给.....沏茶 vi.喝茶.进茶点
tear	n. 眼泪,撕破的(洞或裂缝),撕扯 vt. 撕掉,扯下,扰乱 vi. 流泪,撕破
technique	n. 技术
context	n. 上下文, 环境,背景
revenue	n. 总收入; 财政收入, 税收 n. 税务局
official	adj. 官方的,正式的,有权威的 n. 官员
advise	vt. 劝告,警告,通知 vi. 劝告,与...商量
initially	adv. 最初, 开头
affair	n. 事件,事情,事务
application	n.适用，应用，运用； 申请，请求，申请表格； 勤勉，用功； 敷用，敷用药
reflect	v. 反映, 反射, 归咎
tennis	n. 网球
reform	n. 改革,改正,感化 vt. 改革,改正,使悔改 vi. 改良,悔改
totally	adv. 完全
skin	n.皮，皮肤； （蔬菜，水果等）外皮； 毛皮 vt.剥皮，削皮； 擦破皮，擦伤； 欺骗 vi.使愈合，长皮 adj.<俚>色情的
daily	adj. 每日的, 按天计算的, 日常的 adv. 每日,天天 n. 日报, (复)工作样片
register	v. 记录, 登记, 注册, 挂号 n. 暂存器, 记录, 登记簿 n. (语)语域; 通风调节设备
existence	n. 存在, 生存
gray	n.灰色； 灰马； 灰色颜料； 暗淡的光线 adj.灰色的； 灰白头发的； 阴暗的； （指脸因恐惧、生病等）苍白的 v.（使）变灰色 vi.成为灰色或灰白
dangerous	adj. 危险的,引起危险的
widely	adv. 广泛地
artist	n. 艺术家, 美术家, 艺人
dark	adj.黑暗的； 乌黑的； 忧郁的； 神秘的 n.黑暗； 暗色； 暗处
green	adj.绿色的； 未熟的，青春的； 未成熟的； 主张保护环境的 n.绿色蔬菜； 绿色的衣服； 植物 vi.绿化，使重视环境保护问题
data	n. (datum的复数)资料,数据
relate	vt.& vi.（把…）联系起来； 讲，叙述（故事等） vt.讲述，叙述； 使…有联系； 建立或展示联系 vi.有联系； 涉及； 符合； 发生共鸣
invest	vt.& vi.投资； 花费 vt.授予，使就职； 给…穿衣，装饰； 使充满； 覆盖
window	n. 窗户
slowly	adj. 慢慢地 adv. 缓慢地
thick	adj. 厚的,浓密(重)的,笨的 adv. 厚,浓,密 n. 密集处,最厚处
rely	v. 信赖,倚赖,信任
passage	n. 通道,走廊,一段文章,旅程 vi. 通过 vt. 通过
middle	n.中部，中间； 腰部； 中央； 正中 adj.中部的； 中央的； 正中的； 中间的 vt.把…放在中间； 把…对折 vi.放在中间； 对折
card	n. 卡片,纸牌,名片,打牌,节目单 vt. 附上或提供卡片,印卡,在卡片上列出,检查资格
hair	n. 头发, 毛发, 毛织物, 极少量, 极短距离
deep	adj. 深的,有...深的,深奥的 adv. 深深地,晚地 n. 深处
replace	vt. 取代,更换
largely	adv. 大部分, 主要地
confirm	v. 确定, 批准, 证实
landscape	n. 风景,山水,风景画 v. 美化…的景观,进行造园工程
delay	n. 耽搁,迟滞 vt. 耽搁,延迟 vi. 耽搁
command	n.命令，指挥； 司令部，指挥部； [计算机]指令； 控制力 vt.指挥，控制，命令； 命令； 应得，值得 vi.给出命令； 命令，指令 adj.指挥的，根据命令（或要求）而作的
mistake	n. 错误,误会 vt. 弄错,误认 vi. 犯错
somehow	adv. 不知怎么地,以某种方式
port	n.港口； （事情的）意义； （计算机与其他设备的）接口； （船、飞机等的）左舷 vt.举枪； 持枪； 左转舵 vi.转向左舷 adj.左舷的，左侧的 vt.& vi.转舵（向左），把（舵）转向左边 adv.向左舷，向左
percent	adj.& adv. 百分之一,(与基数词连用)百分之... n. 百分之...
resource	n. 资源,谋略,消遣
respect	n. 尊敬, 敬重; 关系, 方面 vt. 尊敬, 尊重; 关于, 涉及
farm	n. 农场,农田 vt. 务农 vi. 务农
considerable	adj. 相当大的,可观的,重要的
bore	vbl. 忍受(动词bear的过去式) n. 令人讨厌的人,枪膛,孔,井眼,枪管口径,涌潮 vt. 使感到厌烦,钻孔,挖 vi. 挖掘,开凿
desire	n. 愿望, 欲望, 情欲 v. 向往, 要求, 请求 vt. 渴望
tomorrow	adv. 明天 n. 明天,将来
central	adj. 中心的,基本的,折中的,中枢的 n. 电话交流,中央办公室,中心
mood	n. 心情, 情绪, 语气
entire	adj. 全部的,完整的，同性质的，纯正的，全面的
space	n. 位置, 空间, 距离, 太空, 空地, 持续的一段时间 vt. &vi. 均匀隔开, 分隔
chairman	n. 主席, 会长
physical	adj. 身体的,物理的,物质的 n. 体检
reveal	vt. 显示, 透露 n. (外墙与门或窗之间的)窗侧, 门侧 n. (汽车的)窗框
yield	n. 生产量, 投资收益 v. 生产, 屈服, 投降, 弯下去, 凹下去
gather	vt.收集； 聚集，搜集； 收紧，收缩； 采集 vi.逐渐增加，积聚 n.聚集； 衣褶
feed	vt.喂养； 满足（欲望等）； 向…提供； 供…作食物 vi.吃，以…为食； 流入，注入，进入（如油流入机器）； [电子学]馈入 n.饲料（尤指粗饲料），施肥； 喂送； 草料
update	vt. &vi. 更新,补充最新资料 n. 更新
kill	n. 杀, 杀戮 v. 杀, 破坏, 消减
researcher	n.研究员
evening	n. 傍晚, 晚上
tooth	n. 牙齿
difficulty	n. 困难，争议，反对，麻烦
slightly	adv. 些微地, 苗条地
musical	adj. 音乐的 n. 音乐片
knowledge	n. 知识,了解
plain	n. 平原,草原 adj. 简单的,平坦的,平常的,家常的 adj.纯的，不掺杂的
road	n. 路
track	n. 小路, 跑道, 轨道, 踪迹; 惯例, 常规 v. 跟踪, 追踪
directly	adv. 直接地(立即,完全)
asset	n. 资产,有用的东西,优点,长处
scene	n. 场,景,情景
fine	n. 罚款,罚金,结尾 vt. 罚款 vi. 净化，细化 adj. 美好的, 优质的, 精致的，晴朗的, 健康的，纤细的，恭维的，辞藻华丽的 adv. 恰好地，合适地
cinema	n. 电影院,电影
circle	n. 圆周,社交圈,循环 vt. &vi. 包围,盘旋,环绕
nature	n.自然,自然界,自然状态; 本性,天性,性质; 质; 性格; 性; 本质
basis	n. 基础,根据,主要成分
disorder	n. 杂乱,混乱 vt. 扰乱
neck	n. 脖子,颈
negative	adj. 否定的,负的,消极的 n. 底片，负数，否定 vt. 否定
district	n. 区,地区,行政区 vt. 划分区域,划分地区
engineer	n. 工程师 v. 设计,制造 vt. 操纵,设计,建造
divide	vt.& vi.分； 划分； 分离； （使）产生分歧 n.分水岭，分界线； 分配
population	n. 人口
leader	n. 领袖, 领导者
theme	n. 题目, 主题
clothes	n. 衣服
notion	n. 观念,想法,主张
crucial	adj. 关键的,决定性的
document	n. 文件,公文 vt. 记载,用文件等证明 [计算机] 文档
domestic	adj. 国内的, 家庭的, 驯养的 n. 家仆, 佣人
upset	adj. 心烦的 vt. 加厚,推翻,扰乱 vi. 推翻 n. 推翻,混乱
adult	adj. 成年的,成人的，成熟的 n. 成年人
advertisement	n.&amp;adv. 广告
normal	adj. 正常的,正规的 n. 常态, 标准
normally	adv. 正常地,通常地
extent	n. 广度,宽度,长度,大小,范围,范围,程度 n. [律]&lt;英&gt;扣押, &lt;美&gt;临时所有权令
strategy	n. 战略, 策略
press	vt.压，按； 逼迫； 紧抱 vi.压； 逼迫； 重压 n.强迫征兵； 新闻报道，出版物； 压榨； 印刷机（厂）
pretty	adj.漂亮的； 机灵的，聪明的 adv.相当，颇 n.漂亮的人（或东西）
weapon	n. 武器, 兵器
prevent	v. 预防, 防止
stretch	n. 伸展,张开 adj. 可伸缩的 vt. &vi. 伸展,张开,延伸
freedom	n. 自由
scare	vt. 惊吓(惊恐,惊慌) vi. 受惊吓 n. 惊吓(惊恐,惊慌)
imagine	vt. 想像,幻想,猜测 vi. 想像起来,认为
beside	prep. 在...旁边,与…相比
nuclear	adj. 原子核的,原子能的
sea	n. 海, 海洋
numerous	adj. 为数众多的,许多
import	n. 进口 vi. 进口,输入 vt. 输入,进口
importance	n. 重要,重要性
drop	n. 滴,微量,落下 vt. 使落下，减少 vi. 落下，减少，减弱
beyond	adv. 在更远处,另外 n. 远处, 来世 prep. 超出, 越过,另外
absence	n. 没有；缺乏；缺席；不注意
object	n. 物, 物体, 目标, 宾语 v. 反对，提出...作为反对的理由
scream	n. 尖叫声 v. 尖叫, 大笑
improve	vt. 改进,利用,(提高)价值 vi. 改进
observation	n. 观察,观察力,评论 adj. 被设计用来观察的
king	n. 国王
anyone	pron. 任何人
obvious	adj. 明显的,显而易见的
anywhere	adv. 任何地方 pron. 任何(一个)地方
fresh	adj.新鲜的； 淡水的； 新的； 无经验的 adv.刚； 最新的 n.开始； 新生； 泛滥； 淡水流
secondary	adj. 中级的,中等的,次要的 n. 次要位置, 副手
originally	adv. 本来,原来,最初 重要的
arrange	vt. 安排,整理,计划,改编(乐曲) vi. 协商,计划
seed	n. 种子 vi. (植物)结实,播种 vt. 播种
aim	n. 目标,对准, 枪法 vt. 瞄准, 针对 vi. 旨在, 瞄准, 打算
aside	n. 旁白,顺便说的话 adv. 在一边,另外,离开
patient	adj. 有耐心的, 能忍耐的 n. 病人
self	n. 自我, 自己, 本身
easily	adj. 容易地,不费力地 adv. 容易地
board	n. 木板, 甲板, 董事会 n. 伙食; 舞台, 演员的职业; 船舷 vt. 登(飞机、车、船等); 有偿提供食宿; 用木板覆盖 vi. 搭伙
conduct	n. 行为, 举动, 品行 v. 引导, 指挥, 管理 vt. 导电, 传热
avoid	v. 避免 vt. 避免,逃避
appoint	vt. 任命,指定,预约,装饰 vi. 行使任命权
neighbor	n. 邻居 v. 邻接, 毗邻而居, 友好
connect	vt. 连接,联通,使有联系 vi. 连接,接通
efficient	adj. 效率高的,有能力的
effort	n. 努力, 努力的成果
bottom	n. 底部;臀部;船身;水底;服装下面的部分;低洼地;底色;尽头 adj. 底部的 vt. 给...装底,建立基础,到达底部 vi. 到达底部,垫底，降到最低点
famous	adj. 著名的,一流的
variation	n. 变化,变动,变种,变奏曲
spell	v. 拼写，缓慢地或吃力地读 n. 魅力，符咒 vt. 用符咒镇住(某人) n. 一段时间，轮班 v. 轮班，休息
branch	n. 分支,树枝 vt &vi. 分支, 分岔
demonstration	n. 示范,实证,表达,集会
separate	n. 分开, 抽印本 adj. 分开的, 各自的, 单独的 v. 分开, 隔开, 分居
lunch	n. 午餐 vi. 吃午餐 vt. 请客吃午餐
breast	n. 胸脯,乳房 vt. 挺胸迎...而上
retirement	n. 退休，隐匿处 adj. 退休的
behavior	n. 行为,举止
administration	n. 行政,管理,中央政府
employee	n. 雇员
violence	n. 暴力,狂热
brief	n. 摘要,简报,公事包 adj. 简短的,简洁的 v. 对...作简报,摘要
direct	adj. 笔直的,直接的,坦白的 vt. 指挥，命令，负责 vi. 指导，指出
convert	v. 使转变, 使...改变信仰, 倒置 n. 皈依者, 改宗者
cook	vi. 烧菜, 发生, 做好 vt. 编造, 烧, 虚构 n. 厨师, 烧菜
spirit	n. 精神
opportunity	n. 机会, 时机
crowd	n.人群； 群众； 一群 vi.拥挤，聚集 vt.挤满； 将…塞进； 催逼
voice	n. 声音,嗓音,呼声,歌唱才能 vt. 表达,调整声音,发音
core	n.中心，核心，精髓； 果心，果核； [地质学]地核； [计] 磁心 vt.去（果）核，挖去…的果心； 提取岩芯（样品）
engage	v. 答应, 预定, 使忙碌, 雇佣, 订婚
vote	v.投票，选举； 提议； 投票表决； 公认，由舆论决定 n.投票，表决； 投票数； 投票权； 决议
ship	n. 船,舰,船员,飞船 vt. 以船运送,乘船,运送,进水,在船上工作 vi. 上船,坐船,运送,在船上工作
shirt	n. 衬衫
council	n. 理事会,委员会, 商议
glad	adj.高兴的，乐意的； 令人高兴的，使人愉快的； （风光）明媚的，（景色）美丽的； 充满欢乐的，兴高采烈的 vt.使高兴
maintain	vt. 维持; 维修, 保养; 坚持; 断言
quickly	adv. 快, 迅速
industrial	adj. 工业的,产业的 n. 工业公司
industry	n. 工业,产业,勤勉,刻苦
waste	vt. 浪费, 使瘦弱, 逐渐消耗 vi. 挥霍, 规模缩小, 大伤元气 adj. 荒芜的, 未开垦的, 废的 n. 浪费, 废料, 垃圾, 荒漠, 凄凉的景象
burn	n. 烧伤,灼伤 vt. &vi. 燃烧,烧着,烧毁,灼伤
wave	n. 波,波浪,波动 vi. 波动, 挥动, 起伏, 挥手 vt. 使成波形
pitch	n.场地； 最高点； 音高； 说教 vt.用沥青涂； 扔，投； 树起，搭起； 定位于 vi.抛，扔； [棒球]当投手； 搭帐篷； 向前跌或冲
target	n.（服务的）对象； 目标； （射击的）靶子； 目的 vt.瞄准； 把…作为攻击目标
criminal	adj. 犯罪的, 刑事的, 无耻的 n. 罪犯
crisis	n. 危急关头,危机
enemy	n. 敌人, 有害物, 敌对势力
cultural	adj. 文化的,和养动植物有关的
blow	n. 吹；打击；殴打 vi. 风吹；喘气 vt. 风吹
representation	n. 表示法,表现,陈述，答辩
realize	vt.实现； 了解，意识到； （所担心的事）发生； 以…价格卖出 vt.& vi.变卖，赚得
everybody	pron. 每人, 人人，各人
helpful	adj. 有帮助的, 有益的
evidence	n. 根据, 证据 vt. vi. 证实, 证明
instead	adv. 代替, 反而
recommend	vt. 建议, 推荐, 劝告 vt. 使成为可取, 使受欢迎
governor	n. 统治者, 管理者, 理事
appearance	n. 外表,出现,出场
ease	n. 安乐,安逸,悠闲 vt. 使...安乐,使...安心 v. 减轻,放松
exception	n. 除外,例外
symbol	n. 符号, 标志, 象征
page	n. 页 v. (给...)当听差 vt. (通过扩音器、传呼机等)呼叫
terrible	adj. 可怕的,糟糕的,极其的
excuse	n. 借口,理由；低劣的样品,假条 vt. 原谅,辩解,准许离开,同意赦免
pair	n. 双,对,副 vt.& vi. 使...成对,配对
calculate	vt. 计算,估计,考虑,推测 vi. 计算,预测,依赖
sky	n. 天空 v. 把...投向空中，将…高挂
exhibit	n. 展览品,展览,物证 vt. 展览，展现，显出(感情或品质),提出证据 vi. 展览
interaction	n. 相互作用, 相互影响
integrate	v. 整合, 使...成整体
introduce	vt. 介绍, 引进, 采用, 提出, 提倡, 放入
decline	n. 衰微, 跌落; 晚年 v. 降低, 婉谢
reject	n. 被拒之人,不合格品,不及格者 v. 拒绝,驳回,丢弃
wild	adj. 放荡的,未开发的,野生的,原始的 n. 荒野,野生状态 adv. 野性地,未被约束地,偏离预计路线地
campaign	n. 战役; 运动, 活动 vt. 参加竞赛 vi. (从事, 组织)活动
appreciate	vt. 欣赏,感激,赏识 vt. 领会，充分意识 vi. 增值
winner	n. 获胜者
justice	n.正义； 公正； 法律制裁； 审判员，法官
rapidly	adv. 迅速地
pleasure	n. 高兴, 愉快, 快事 vt. 使高兴 vi. 享受快乐, 高兴
guard	n. 守卫者,警戒, 护卫队, 保护 vt. &vi. 保卫,看守,警惕
extreme	adj. 极度的,极端的,尽头的,严重的,末端的 n. 极端,极限
extremely	adv. 极其, 非常
capacity	n. 能力, 容量, 容积; 资格, 职位 adj. (达到最大容量)满的
significantly	adv. 较大地(重要地)
path	n.小路，路； 路线，路程； 〈比喻〉（人生的）道路； （思想，行为，生活的）途径
abandon	n. 放纵 vt. 放弃,遗弃,沉溺
shout	n. 呼喊,突发的大叫 vt. 高声呼喊，呼叫 vi. 呼叫，突然喊叫
repair	vi. 去，集合 n. 修理, 补救 v. 修理, 补救, 补偿 n. 维修工作，维修状态
careful	adj. 小心的, 仔细的
criterion	n. 标准, 准则
defeat	n. 败北,失败 vt. 击败
joke	n. 笑话,玩笑 vt.& vi. 开玩笑
threaten	vt. &vi. 威胁,构成威胁
minister	n.大臣； 部长； 公使； 牧师 vi.辅助，服侍； 执行牧师职务
definitely	adj. 明确地, 确切地 adv. 肯定地
degree	n. 学位，程度, 度数
judge	vt.& vi.审判，评判； 断定 vt.估计； 评价； （尤指）批评； 想，认为 n.法官； 裁判员； 评判员； 鉴定人
reputation	n. 声誉,好名声
license	n. 批准,许可证,特许 vt. 允许,特许
discount	n. 折扣, 贴现率 vt. 打折扣, 贴现, 不重视，不全信 vi. 贴现, 减息贷款
cat	n. 猫,猫科动物,邪恶的女人,吊锚机,单帆小船 vt. 吊锚 vi. 寻找性交伴侣 (CAT) 电子计算机横断层扫描
happy	adj. 快乐的,幸福的,乐于做某事
perceive	v. 察觉, 感觉, 认知, 理解
perfect	adj. 完美的；最好的；精通的 vt. 使完美；使熟练 n. 完成式
sex	n. 性,性别,性欲 vt. 区别...性别,引起...性欲
somewhere	adv. 在某处，到某种程度，大约，差不多
song	n. 歌曲, 歌唱艺术, 诗歌
personal	adj. 私人的,个人的 n. (报刊的)私人专栏
hate	n. 憎恨,厌恶,厌恶的人或事 vt. 憎恨,不愿 vi. 表示憎恨
south	adj. 南方的 adv. 在南方 n. 南,南方
foot	n. 脚,山脚,最底部, 一步长,音步，进程 vi. 跳舞,步行 vt. 表演舞步,付账, 踩踏, 结算
fear	n. 敬畏,害怕,担心,不安的原因 vt. 害怕,敬畏
retire	n. 退休,退职 vi. &vt. 退休,撤退
favor	[美]n. 好意,喜爱,偏爱,特权 vt. 给予,关心,偏爱,支持,利于,长得像
gold	adj. 金色的,金制的 n. 金子,金币,金黄色,金牌
mountain	n. 山,山脉,大量
charge	n. 电荷, 指控, 费用; 照顾, 责任 vt. &vi 控诉, 加罪于, 要价, 赊帐, 充电, 管理
movie	n. 电影
drama	n. 剧本,戏剧,戏剧性情节,刺激
kitchen	n. 厨房
differ	vi. 不一致,不同(意见)
author	n. 作者,创造者 vt. 创造,写作
field	n. 领域；牧场；旷野；战场；运动场 vi. 担任场外队员 adj. 扫描场；田赛的；野生的 vt. 把暴晒于场上；使上场；(通常成功地)回答，处理(问题)
ring	n. 环, 戒指, 铃声, 圈 vt. 包围, 挂铃铛 vi. 鸣响, 回响, 在空气中螺旋上扬, 形成圈
studio	n. 工作场所,画室，照相室，制片厂
height	n. 高度,高处,身高, 最高峰, 极点
award	vt.授予，奖给，判给； 判归，判定 n.奖品； （仲裁人、公断人的）裁定； （法院、法官的）判决； 裁定书
disadvantage	n. 不利, 不利条件, 损害, 损失
narrow	adj. 狭窄的，有限的；勉强的；精密的；度量小的 n. 海峡；狭窄部分，隘路 vt. 使变狭窄 vi. 变窄
disaster	n. 灾难
rarely	adv. 很少,难得
discipline	n. 训练, 纪律, 惩罚; 学科 vt. 训练, 惩罚
native	adj. 本国的,本土的,出生地的,天生的 n. 本地人,土著人
plot	n. 阴谋, 情节，图, (小块)土地， v. 绘图, 密谋, 计划，标示位置
firm	n. 商行,公司 vt. (使)变得坚实,定案 vi. 变硬,恢复 adj. 坚定的,坚固的,结实的 adv. 稳固地,坚定地
dish	n. 盘碟,菜肴,凹形 vt. 装盘,提出,揭露,挖空 vi. 闲谈
satisfaction	n. 赔偿,满意,妥善处理,乐事,确信
nearly	adv. 几乎, 差不多
classroom	n. 教室，课堂
stare	vt. 凝视,显眼,变硬 vi. 凝视 n. 凝视
pollution	n. 污染, 污染物
climate	n. 气候, 风气, 气氛
nevertheless	adv. 仍然, 不过 conj. 然而, 不过
partner	n. 合作者,搭档,配偶 vt. &vi. 同...合作,做...的搭档, 合作
assumption	n. 假定,设想,担任(职责等),假装
trust	n. 信任,信托 vi. 信任 vt. 委托,相信
fascinate	vt. 使...入迷,吸引住 vi. 有吸引力
lean	n. 瘦肉,倾斜,弯曲 adj. 瘦的,贫乏的,歉收的 vi. 倚靠,倾斜,依赖 vt. 使倾斜
nine	num.&amp;n. 九 pron.&amp;adv. 九(个,只...)
brand	n. 燃烧的木条,剑,商标,牌子,烙印,类型 vt. 打烙印,污蔑,铭记
pound	n.英镑； 磅； 兽栏； 重击声 vt.& vi.连续重击； 咚咚地走 vi.（持续地）苦干； （驾舟时）拍打（水面）； （心脏）狂跳； 脚步沉重地走（或跑） vt.连续重击； 捣碎，碾碎； 强迫吸收； 猛烈袭击
nobody	pron. 没有人 n. 无足轻重的人
noise	n. 声音,响声,喧哗声,噪声 vt. 谣传 vi. 大声说话, 发出噪音
college	n. 学院, 学校，社团，枢机主教团
doubt	n. 怀疑,疑惑,不信任 vt. 怀疑,不信任 vi. 不确定
cycle	n. 循环,周期,长期,圈,套曲,自行车, vt. 环行,骑自行车 vi. 使环行
hurt	vt. 伤害,(使)疼痛, 损害 vi. 受疼痛，破坏 n. 打击，创伤
north	adj. 北,北方(的) adv. 向北方 n. 北,北方
identify	vt.识别，认出； 确定； 使参与； 把…看成一样 vi.确定； 认同
forget	vt. &vi. 忘记,忽略
investor	n. 投资者
formula	n. 公式,配方,规则；代乳品 adj. （赛车的）级的，方程式的
previously	adv. 以前(预先)
image	n. 图像,影像,肖像,想像,形象 vt. 想像,描绘,反映
corporate	adj.社团的, 法人的, 共同的, 全体的
immediate	adj. 立即的, 即刻的, 直接的, 最接近的
likely	adj. 可能的,合适的,可信的,有前途的,有吸引力的 adv. 很可能
imply	vt. 暗示,意味
prisoner	n. 囚犯
angry	adj. 生气的,伤口红肿的
common	adj. 共同的, 平常的, 普通的 n. 平民, 普通, 公地, 公园
medical	adj. 医疗的,医学的,药物的,需治疗的
observe	v. 观察, 遵守, 注意到
presidential	adj. 总统的
obtain	vt. 获得, 得到 vi. 通用, 流行, 存在
obviously	adv. 显然地
due	adj.由于； 适当的； 预定； 到期 n.应有的权利； 应得到的东西； 应缴款 adv.正向； 正对着
competition	n. 比赛,竞争
friendly	adj. 友好的 adv. 友好地 n. 友好者
promise	n. 诺言, 约定, (有)希望，预示 v. 允诺, 约定, 预示, 有可能
suffer	vt. 遭受,忍受,允许 vi. 忍受,经历
sufficient	adj. 足够的, 充分的
frequently	adv. 经常地, 频繁地
ear	n. 耳朵, 听觉, 倾听, 麦穗 vi. 长出麦穗
supplier	n. 供应者, 供应厂商, 供应国
locate	vt. 找出,设于,位于,建立 vi. 建立
budget	n. 预算 vt. 编预算,为…做预算 vi. 节省开支 adj. 不贵的，廉价的
earn	vt. 赚得, 赢得, 生利
fundamental	adj. 基本的,根本的,重要的 n. 基本原理,基础
earth	n. 地球,泥土,世间,大地,地球人 vt. 赶入洞中,提取土壤 vi. 躲入洞穴
conclude	vt. 使结束, 缔结, 断定, 得出结论 vi. 结束, 作出决定
usual	adj. 通常的
edge	n. 边,边缘,刀口 vt. 给...加上边,缓慢横过,使逐渐丧失 vi. 徐徐前进
garden	n. 花园, 果园, 菜园, 草地 vi. 栽培花木, 从事园艺工作 vt. 造园, 以花园装饰 adj.花园的, 园艺的, 绿化的, 平凡的
surprise	n. 惊奇, 使惊讶的人或事物 vt. &vi. 使惊奇, 突击, 逮捕
sentence	n. 句子,意见,宣判,刑罚,命题 vt. 宣判,判决,使遭受
egg	n. 蛋; (俚语)人
eight	num. 八 pron. 八(个,只...)
beer	n. 啤酒
boundary	n. 分界线, 边界
consideration	n. 考虑, 体贴, 考虑因素, 敬重, 意见
belief	n. 相信, 信念, 信仰
beauty	n. 美,美丽,美人,美的东西
achieve	vt. 完成,达到,实现 vi. 达到目的
baby	adj. (形容用法)婴儿的, 过小的 n. 婴儿, 象婴儿的人, 需特殊关心的事物 vt. 溺爱, 过度关心
overall	adj. 全部的, 全体的, 一切在内的 adv. 总的来说, 全部地 n. 防护服，罩衫
settlement	[建]沉降; 解决, 结算,殖民(地), 租界; 居留地; 新建区; 住宅区
victory	n. 胜利
personally	adv. 亲自地, 以个人, 就自己而言
recognition	n. 认出,承认, 感知，知识
operate	vi. 操作, 运转 vt. 起作用, 动手术
encourage	v. 鼓励,激励,支持 vt. 鼓励
hardly	adv. 几乎不
minimum	adj. 最低的, 最小的 n. 最小量, 最低限度
majority	n.多数； （获胜的）票数； 成年； 法定年龄
option	n.选择（的自由）； 选项； 选择权； 选择能力 vt.得到或获准进行选择； 调动球员
agency	n. 代理,代理处,政府机构
race	n. 种族, 赛跑 v. 赛跑, 竞赛 n. 人种；种族
correct	adj. 正确的 v. 改正,纠正 vt. 改正
shift	n. 交换,变化,移动,接班者 vt. 更替,移转,变声 vi. 改变,定责,更衣
enormous	adj. 巨大的, 庞大的
sir	n. 先生
county	n. 郡, 县
couple	n. 对, 夫妇, 数个 v. 加倍, 成双, 连结
double	n. 两倍,复制品,替身,双重角色的演员,反转,双人房 adj. 两倍的,双重的,骗人的,加量的 adv. 两倍地,双人地,翻来覆去地,对折地 vt. 使加倍,对折,握紧,做替身 vi. 加倍,转身,兼任,替代演出
environment	n. 环境,外界
equal	adj. 相等的,平等的,胜任的 n. 对手,匹敌,同辈 vt. 等于,比得上
handle	n. 柄,把手 vt. 买卖,处理,操作 vi. 驾驭
rare	adj. 稀罕的, 罕见的, 珍贵的
wash	v. 洗, 洗涤, 洗清 n. 洗, 洗濯
crack	vt.破裂，打开； （使…）开裂； 说（笑话）； 开瓶 vi.断裂，折断； 碎裂声，爆裂声； 镜子破裂了； 失去控制，衰退 n.裂缝； 试图； 缝隙； （可听到响声的）重击 adj.训练有素的； 技艺高超的； 优秀的； 一流的
square	n. 正方形,街区,平方，广场 adj. 正方形的,正直的,公正的,结实的 vt. 使...成方形,调整，一致 vi. 符合 adv. 成直角,直接的,正方形地
red	adj. 红色的 n. 红色
amaze	v. 使吃惊
proportion	n. 比例,均衡,部份 vt. 使成比例,使均衡,分摊
establish	v. 建立, 确立, 创办
weak	adj. 不充分的, 淡薄的, 弱的, 虚弱的, 无力的
estimate	n. 估计, 估价 v. 估计, 估价, 评价
crime	n. 犯罪, 羞耻, 罪行
screen	n.屏幕； 银幕； 屏风 vt.筛（煤、矿石等）； 拍摄； 放映（电影）； 庇护
site	n. 位置,场所 v. 使...位于,使...放置
wet	adj. 湿的,雨天的 n. 潮气,雨天 vt.& vi. (使)弄湿
inside	adj. 里面的 adv. 在里面 n. 内部 prep. 在...里面
outline	n. 大纲,轮廓,概要,略图,素描 vt. 描画轮廓,描述要点
consumer	n. 消费者,用户, 消费品
inspire	vt. 影响，使...感动, 激发，煽动 vi. 吸入
guy	n. (男)人,家伙,拉索 vt. 嘲笑
weight	n. 重量,体重,重担 vt. 使...负重, 使倾斜
welcome	vt.欢迎； 乐于接受 adj.受欢迎的； 令人愉悦的； 表示感谢的 n.欢迎，迎接
master	n. 主人, 硕士, 母机 adj. 主人的, 主要的 v. 征服, 控制, 精通
west	adj. 西方的 adv. 向(在)西方 n. 西, 西方
instrument	n. 乐器, 工具, 仪器, 器械
temperature	n. 温度,发烧
appeal	n. 恳求, 上诉, 吸引力 n. 诉诸裁决 v. 求助, 诉请, 呼吁; 有吸引力
reduction	n. 减少,缩小, (化学)还原反应, (数学)约分
except	vt. 除,除外 prep.&conj. 除了...之外,若不是,除非
attack	vt.& vi.攻击，进攻，抨击 n.攻击； 抨击； （队员等的）进攻； （疾病）侵袭 vt.抨击； 非难； 侵袭； 损害
whenever	adv. 无论何时 conj. 每当, 无论何时, 随时
pack	n. 包裹,一群,一副,一帮,一群 vt. 包装,捆扎,塞满, 收拾行李， 佩戴 vi. 包装，（用某物）保存，保藏 ,塞进
meal	n. 膳食,一餐,谷物粗粉 vi. 进餐
variable	adj. 可变的,易变的 n. 变量, 易变的东西
grand	adj. 豪华的,宏伟的,壮丽的,主要的,重大的 n. (美俚)一千美元
refuse	n.废物,垃圾 vt. &vi. 拒绝 adj. 无用的
exercise	n. 练习,作业,运动 vt. 运用 vi. 锻炼
currently	adv. 现在，现时，目前，当前
international	adj. 国际的 n. 国际组织
arise	vi. 上升,引起,出现
damage	n. (pl.)赔偿金,损坏,毁坏 vt. 损害,毁坏
arrest	n. 逮捕,监禁 vt. 拘捕,妨碍,吸引
introduction	n. 介绍, 引进, 导论, 序言
expensive	adj. 昂贵的,豪华的
calm	n. 平稳,风平浪静 adj. 平静的,冷静的 vt.&vi. 平静下来,镇静
appointment	n. 约会, 预约, 任命, 委派, 官职, 设备
relationship	n. 关系, 关联
provision	n. 规定, 条款; 供应(品); 预备 n. (pl.) 食物 vt. 向...供应食物
partly	adv. 在一定程度上，部分地，不完全地
finger	n. 手指,指针 vt. 用手指触碰（演奏），（用手）指， vi. 触摸，用手指演奏乐器，
actor	n. 男演员
winter	n. 冬天,年,萧条期 adj. 冬天的,冬季生长的 vt.& vi. 过冬
expression	n. 表达,表示,表现,表情,措辞,词句
thin	adj. 瘦的,稀少的 adv. 薄,细,瘦,稀薄(的) vt.& vi. (使)变薄
fan	n. 风扇,扇形物,狂热者 vt. 风选,煽,吹,煽动,向扇子一样展开 vi. 像扇子一样行动,鱼贯而出
message	n. 消息,信息,要点 vt. &vi. 传递信息, 通讯
metal	n. 金属,质料 adj. 金属制的 v. 以金属覆盖
guilty	adj. 有罪的, 内疚的
capture	n. 抓取,战利品,捕获之物 vt. 抓取,获得,迷住
hall	n. 大厅, 礼堂
joint	adj. 联合的, 共同的 n. 关节, 接合处 v. 连接, 贴合
threat	n. 威胁, 凶兆
preserve	vt.保护； 保持，保存； 腌制食物； 防腐处理 vi.保鲜； 保持原状； 做蜜饯； 禁猎 n.蜜饯； 防护用品； 禁猎地； 独占的事物（或范围）
journalist	n. 记者, 新闻工作者
faith	n. 信任,信仰
peace	n. 和平,安静
peak	n. 山顶,顶点,帽舌 vi. 到达高点,消瘦 vt. 使到达顶峰,竖起 adj. 处于顶峰状态的
cash	n. 现金 vt. 兑现,付现款 adj. 现金的
legislation	n. 立法, 法律
aircraft	n. 飞机
reserve	n. 预备品, 贮存, 候补 n. 克制, 含蓄 vt. 保留, 预订, 延期
somebody	pron. 某人, 有人 n. 重要人物
temporary	adj. 暂时的,临时的 n. 临时工
thus	adv. 如此,这样,因此,从而 conj. 因此,于是
bike	n. 脚踏车
grateful	adj. 感激的, 感谢的
perform	v. 执行, 表演, 做
modern	adj. 现代的,时髦的 n. 现代人,时尚人士
till	conj. 直到(...为止) n. (账台中)放钱的抽屉 prep. 直到 pron. 直到...为止,直到 vt. 耕种
respond	vi. &vt. 回复,反应，响应，应答 n. 拱柱
equally	adv. 相等地, 同样地, 平等地
software	n. 软件
tip	n. 顶, 尖端, 小费，指点 v. 提出建议或意见, 倾斜, 给小费, 轻触
perspective	n. 远景, 看法, 透视 adj. 透视的
persuade	v. 说服 vt. 劝说,说服
despite	prep. 不管, 尽管 v.憎恨, 轻视
abuse	n.滥用； 恶习； 侮辱； 恶言 vt.滥用； 虐待； 辱骂
retain	vt. 保持, 保留; 记住
fat	adj. 肥胖的,厚的,大的,大量的,丰厚的,愚蠢的 n. 脂肪,动植物油,精华,肥胖,过剩 vt. 使变胖 vi. 变胖
scale	n. 鳞, 刻度, 衡量, 数值范围 v. 依比例决定, 攀登
career	n. 生涯, 职业, 事业 vi. 猛冲, 飞跑 vt. 在...中急行
character	n. 个性, 品质; 字符; 人物; 名誉; 地位
tonight	n.&amp;adv. 今晚
ride	n. 乘坐,乘车,搭便车 vt. &vi. 骑,乘坐,经受住
fellow	n. 朋友,家伙,同类,校董,研究生 adj. 同类的,同事的,同伴的
kiss	vt.接吻； 轻拂； 轻微碰撞 vi.接吻； 轻触 n.吻； 轻触； 小糖果； 蛋白甜饼，球形饼干
speed	n. 速度,迅速,感光度,超速 vt. 加速,催促,促进 vi. 超速,加速,进展
massive	adj. 巨大的, 大规模的, 大量的, 大范围的
heat	n.热，热度，高温； 热烈，激烈； （身体的）发烧，发热； 发情 vt.&vi.使温暖，使热； 激发…的感情，使兴奋
muscle	n. 肌肉 vt. 用力挤 vi. 用力进行
sad	adj. 悲哀的, 伤心的, 不能令人满意的
aware	adj. 知道的, 意识到的
label	n.标签； 称标记，符号； [建] 门或窗户上面的线脚 vt.贴标签于； 把…称为； 把…列为； [化]用放射性元素使（元素或原子等）示踪
plastic	adj. 塑料的, 可塑的, 体态好的 n. 塑料,(外科)整形的,信用卡
rock	n. 岩石, 巨石, 摇滚乐, 篮球 vt. 摇动, 使震惊, 使动心 vi. 来回摇动, 跳摇摆舞
transfer	n. 迁移, 移动, 换车 v. 转移, 调转, 调任
highly	adj. 十分敬仰的 adv. 高度地,很,非常
civil	adj. 国内的,公民的,文明的, 有礼貌的, 民用的
pocket	n. 口袋,钱,袋 vt. 装...在口袋里,隐藏,私吞 adj. 小型的,钱的
sheet	n. 床单,张,片 vt. 盖上被单,遍布, 使成片状 vi. 成片落下或流动 adj. 片状的
hit	n. 打(击),冲撞,讽刺,成功.一次毒品的剂量,点击量 vt. 打(击),碰撞,偶然发现,要求,符合 vi. 打(击),袭击,达到
row	n. 排,船游,吵闹 vt. 划船,成排 vi. 划船,吵架
politics	n. 政治,政策,政治活动,政见
flat	adj. 平坦的, 单调的, 扁平的 adv. 平直地, 干脆地 n. [英]公寓 vt. 变平 vi. 降调
quarter	n. 四分之一, 一刻钟, 季度, 25美分 vt. 四等分 vi. 住宿, 驻扎 adj. 四分之一的
constantly	adv. 不断地,经常地
therefore	adv. 因此, 所以
truly	adv. 真实地, 不假
leadership	n. 领导, 领导才干
truth	n. 事实,确实,真理,现实
closely	adv. 紧密地，接近地，严密地
clearly	adv. 清楚地
possibly	adv. 可能地, 也许
rural	adj. 农村的
hospital	n. 医院
host	n.[计算机]主机； 主人，东道主； 节目主持人； 酒店业主 vt.当主人； 主办宴会，主持节目； 款待，做东 vi.做主人，做东道主
obligation	n. 义务, 责任
household	adj. 家庭的, 家喻户晓的 n. 家庭, 户
collapse	n. 崩溃,倒塌,暴跌 vi. 倒塌,崩溃,瓦解,折叠 vt. 倒塌,缩减
stuff	n. 材料, 原料, 东西 n. 素质, 本质; 废物 vt. 填满, 塞满
length	n. 长度,篇幅
stock	n.股份，股票； 库存； 树干； 家畜 adj.常备的，存货的； 陈旧的 vt.提供货物； 备有 vi.出新芽； 囤积
advance	n. 前进,进步,预支 vt. 前进，增涨，预先 vi. 前进，提升 adj. 预先的，提前的
advantage	n. 优势,有利条件 vt. 有利于
stone	n.石头； 宝石； 矿石； （膀胱或肾脏中的）结石 vt.向扔石块； 用石头铺； 以石掷向； 除（水果的）硬核 adj.石制的； 石头似的； [S-]石器时代的； 粗陶制的 adv.石一般的
predict	v. 预知, 预言, 预报
dozen	n. (一)打,十二个 adj. 一打的, 十二个的
manner	n. 样子,礼貌,风格,方式
agreement	n. 同意, 一致, 协议
save	vt.节省； 保存； 储蓄； 解救 vi.节省； 挽救； 救球 prep.&conj.除…之外 n.救援，救援
president	n. (国家)总统,(公司)总裁,总经理,社长(日本)
pressure	n. 压力, 压强, 压迫
manufacturer	n. 制造商
former	adj. 以前的,在前的 pron.&amp;n. 前者
kid	n. 小孩, 小山羊, 小山羊皮制品 vi. (山羊,羚羊)生幼崽, 玩恶作剧 vt. 开玩笑, 哄骗, 嘲弄 adj. 相对年幼的
lift	vt. 举起；提升；鼓舞；空运；抄袭 vi. 消散；升起；耸立 n. 电梯；举起；起重机；搭车
candidate	n. 候选人, 求职者
string	n. 线,一串,字串 vt. 串起,成串,收紧, 悬挂；系；扎 vi. 给…装弦 adj. 线的
primarily	adv. 首先, 主要地
drink	n. 饮料 vt. &vi. 喝,喝酒
prime	adj. 最初的,首要的,最好的，典型的 n. 青春,壮年,全盛时期 vt. 事先指点,在（金属、木材等上）打底漆 vi. 变得首要
strongly	adv. 强有力地，坚固地, 坚强地, 激烈地
principal	adj. 主要的 n. 负责人, 校长, 资本
implication	n. 暗示,含意
commercial	adj. 商业的 n. 商业广告
commission	n. 委任(状), 任官令; 委员会 n. 佣金; 犯罪行为 vt. 委任, 委托; 使服役
impression	n. 印象, 效果
objective	adj. 客观的, 目标的 n. 目标, 目的; 物镜 n. =objective case 宾语
fly	n. 苍蝇,两翼昆虫,飞行,升高 vt. &vi. 飞,飞翔,逃走,飞逝,猛然移动
billion	n. 十亿,大量 adj. 大量的
capital	n. 首都,资本,大写字母 adj. 大写的,资本的，首要的
apart	adv. 分别地,分开地，有区别地 adj. 分开的，分离的
professional	adj. 职业(上)的,专业的 n. 专业人员
successful	adj. 成功的,达到目的的
complete	adj. 彻底的, 完整的, 已完成的 vt. 完成; 使圆满, 使完美
complex	adj. 复杂的 n. 复合体
sudden	n. 突然, 忽然 adj. 突然的, 快速的
blame	n. 过失,责备 vt.把...归咎于,责备
silence	n. 沉默,寂静 v. 使沉默,使安静 vt. 使安静,使沉默
fuel	n. 燃料,木炭 vt. 供以燃料 vi. 加燃料
medicine	n. 药, 医学
association	n. 联合,结合,交往,协会,社团,联想
sun	n. 太阳,阳光,中心人物,像太阳般的东西 vt.& vi. 晒太阳
boat	n. 船, 船型物体 vt. 放于船上 vi. 划船
conference	n. 会议
useful	adj. 有用的
wing	n. 翅膀,翼 vt. 给...装上翼,飞行 vi. 飞行
thirty	num. 三十
survive	vt. 比…活得长,幸免于难,艰难度过 vi. 活着, 继续存在
belong	vi. 属于，适合于
accommodation	n. 住处，膳宿；调节；和解；预订铺位
pupil	n. 瞳孔,学生,小学生
various	adj. 各种各样的
category	n. 种类, 类别
vehicle	n. 传播媒介, 工具, 手段, 交通工具, 车辆;
constant	adj. 经常的, 不变的 n. 常数, 恒量
construction	n. 建设，建造，结构，构造
total	adj.总计的（金额等）； 全部的； 完全的； 绝对的 n.总计，总数； 全体数量 vt.& vi.总计达，计算…的总数
contain	vt. 包含,容纳,克制,抑制 vi. 自制
elsewhere	adv. 在别处, 到别处
chip	n. 薄片,碎屑，芯片 vt. 削,切,削成碎片 vi. 折断成碎片
lucky	adj. 幸运的,带来好运的
quality	n. 品质, 特质, 才能 adj. 高品质的
employment	n. 工作,职业,雇用,使用
suddenly	adv. 突然地
visitor	n. 参观者, 访问者，访客
shape	n. 形状,形式,定形,身材 vt. 定形,使...成形,塑造
vital	adj. 至关重要的, 生死攸关的, 有活力的, 充满生机的
bus	n. 公共汽车
single	adj. 单身的,单纯的,单一的 n. 单程票,单曲,单人房,单身者 vt. 单独挑出 vi. (棒球)作一垒打
neighborhood	n. 附近,邻近,邻居
incident	n. 事件,（常指）军事冲突, 插曲，事变 adj. 难免的，附带的，(物理)入射的
broad	adj.宽阔的； 广泛的； 概括的； 明显的 n.婆娘
ordinary	adj. 普通的
shock	n. 震动,冲突,震惊,休克 vt. &vi.震动,冲突,使...受电击
enter	vi. 进入,参加,开始,上台,进入角色 vt. 进入,报名,开始,加入,报价,提出 [计算机] 送入
index	n.索引； <数>指数； 指示； 标志 vt.给…编索引； 把…编入索引； [经济学]按生活指数调整（工资、价格等） vi.[机械学]转位
entry	n. 进入,入口,登记,项目
range	n.范围； 射程； 类别； （山脉，房屋等的）排列 vi.搜索； 变化； 延伸； 漫游 vt.排列； （按一定位置或顺序）排序； 把…分类； 徘徊 adj.牧场的，放牧区的
rent	n. 租金 v. 租 vi. 出租 vt. 出租,租用
warn	vt. 警告,注意,远离 vi. 提醒
implement	n. 工具, 器具; 当工具的物品 vt. 实施, 执行; 向...提供工具(或手段)
escape	n. 逃亡,避难设备 vt. &vi. 逃脱,避开 adj. 逃避的
tall	adj. 高的
inform	vt.通知； 使活跃，使充满； 预示 vi.通知； 告发
manager	n. 经理
profile	n.侧面，半面； 外形，轮廓； [航]翼型； 人物简介 vt.描…的轮廓； 给…画侧面图； 为（某人）写传略； [机]铣出…的轮廓
busy	adj. 忙的,杂乱的 vt. 使忙于 vi. 忙
mom	n. 妈妈 abbr. 月中(=middle of month)
reaction	n. 反应,反作用力,化学反应
outcome	n. 结果
teach	vt. 教,教书,教导，教训 vi. 给予指导
energy	n. 活力,精力,能力,能,能量
panel	n.镶板； 面； （门、墙等上面的）嵌板； 控制板 vt.选定（陪审团）； 把…分格； 在…上置鞍垫； 把…镶入框架内
wear	n. 穿著,磨损,耐久性 vt. 穿著,用旧,耗损,呈现 vi. 磨损, 变旧
announce	vi.宣布参加竞选； 当播音员 vt.宣布； 述说； 声称； 预告
simply	adv.&amp;adj. 简单地,仅仅
recent	adj. 近来的, 新近的
unlike	adj. 不同的, 不相似的 prep. 不像, 和...不同
mass	n. 块,大量,众多 adj. 群众的,大规模的 v. 集中 n. pl. 群众，民众
anybody	n. 重要人物 pron. 任何人
institution	n. 机构,惯例,创立
culture	n. 文化,教养,种植 vt. 培养
sink	n. 接收端,沟渠,污水槽,散热器 vi. 下沉,下落,陷于,倾斜,恶化,渗透 vt. 下沉,陷于,倾斜,减少
insurance	n. 保险
owner	n. 所有人, 物主
traffic	n.交通，运输量； （非法的）交易； 通信量； 交际 vt.用…作交换； 在…通行 vi.交易； 买卖
maximum	n. 极点, 最大量, 极大 adj. 最高的, 最大极限的
taste	n. 味道,品味,味觉,尝试 vt. 尝到甜头, 尝试, 有...味道的 vi. 品尝, 体验
tend	vt.照料，照顾； 护理； 照管，管理 vi.倾向（于），趋向（于）； 伺侯，招待； 关心； 注意
package	n. 包裹,整批交易 vt. 把...打包,把...进行推销
skill	n. 技能, 技巧
appropriate	adj. 适当的, 相称的 vt. 拨出(款项); 占用
exhibition	n. 展览,展览会
wide	adj. 广泛的,宽阔的 adv. 广大地,全部地
slide	n. 滑,幻灯片,雪崩,山崩,滑坡,滑梯 vt. 使滑 vi. 滑,跌落
experiment	n. 实验,试验,尝试 vi. 做实验,尝试
camp	n. 露营,帐棚,训练营,做作 vt. &vi. 露营,扎营,做作 adj. 做作的
investment	n. 投资,投入,投资额
advice	n. 忠告，建议，劝告
dead	adj. 死的,萧条的,精疲力竭的,用完的,无趣的 adv. 完全地,突然地,直接地 n. 死者,死
ground	n. 土地,战场,场地,根据,背景 vt. 放在地上,使...搁浅,打基础 grind的过去式和过去分词
excellent	adj. 极好的,优秀的
smart	adj. 聪明的,时髦的,漂亮的,敏捷的,轻快的,整洁的 vi. 刺痛,难过,烦恼 n. 刺痛,苦恼 adv. 轻快地,,机灵地,整齐地,漂亮地; v. 感到剧烈刺痛，（因批评、失败等）难过，烦恼
gift	n. 礼物,天赋,赋予 vt. 赠送,赋予
relax	vi. 放松,松懈,松弛 vt. 放松,放宽(限制等)
item	n. 项目,条款， 一件商品（或物品） adv. 也
guess	n. 猜测,推测,猜想 vt. &vi. 猜测,推测
meter	n. 公尺,韵律,计量器 vt. 用表测量[计量, 记录]
capable	adj. 有能力的，足以胜任的, 有...倾向的
remind	v. 提醒 vt. 使想起,提醒
aspect	n. 方面, 外貌, 外观; 方位, 方向
ideal	adj. 理想的, 完美的, 高尚的 n. 理想, 典范, 目标
assess	v. 估定, 评定
mile	n. 英里,大量,海里,一英里赛跑
assist	n. 帮助,协助,协助的器械 vt. 帮助,协助 vi. 帮助,协助,出席
assistant	adj. 助理的；辅助的。 n. 助手助理；助教，店员
thousand	adj. 千,成千
definition	n. 定义, 阐释，清晰度
miss	n.（用于姓名或姓之前，对未婚女子的称呼）小姐； 女士； 失误 v.漏掉； 错过（机会）； 思念； 没遇到
demand	n. 要求; 需求 v. 要求, 查问; 需要
familiar	adj. 熟悉的,熟知的,不拘礼节的 n. 熟人,熟悉某种事物的人
catch	n. 捕捉,陷阱,捕获物,接(球等),扣栓物,隐患 vt. 抓住；赶上,了解,感染,被钩住,击中,察觉 vi. 抓住，燃着
mix	n. 混合(物),融合 vt. &vi. 混合,掺入,合成,交往,联系 [计算机] 混合
worth	adj.值得的； 有…的价值； 等值的； 有…的财产 n.财富，财产； 价
resolve	n. 决定之事,决心,坚决 vt. 决定,解决,分离,表决 vi. 分离,决定
somewhat	adv.稍微； 有点； 达到某种程度 n.少量； 某些数量； 某种程度
permanent	adj. 永久的, 持久的 n. (口)烫发
son	n. 儿子
farmer	n. 农夫
permit	n. 许可证,执照 vt. &vi. 允许,许可
writer	n. 作者, 作家
assume	vt. 假定, 设想, 承担; (想当然的)认为
fish	n. 鱼，鱼肉 v. 钓鱼，捕鱼
acquisition	n.获得； 购置物； 获得物； 收购
dominate	v. 支配, 占优势，俯视
determine	vt.& vi.（使）下决心，（使）做出决定 vt.决定，确定； 判定，判决； 使决定； 限定 vi.[主用于法律]了结，终止，结束
gate	n. 大门
challenge	n.挑战； 盘问； 质疑； 怀疑 vt.质疑； 向…挑战 vi.提出挑战，要求竞赛（或竞争）； 驳斥
spare	adj. 多余的, 闲置的, 备用的, 简陋的 v. 抽出，饶恕，赦免，节约 n. 剩余, 备用品
map	n. 地图 v. 映射,绘制...之地图,计划 [计算机] 存储区分配图
yourself	pron. 你(们)自己, 你(们)亲自
youth	n. 年轻人, 年轻
piece	n. 块,片,篇 vt. 修补,结合
speech	n. 演讲,对话,话语,语言
heart	n. 心,中心,要点,在扑克牌中指红桃 v. 鼓起勇气,激励
authority	n. 权威；权力；当局
murder	n. 谋杀,危险物 vt. 谋杀,折磨,损坏 vi. 谋杀
tour	n. 旅游, 观光旅行, 任期 v. 旅行, 周游
split	n. 劈开, 裂片, 裂口 adj. 分散的 v. 分离, 分开, 劈开
ourselves	pron. 我们自己
sport	n. 运动,游戏,娱乐,玩笑,大度的人 adj. 运动的,休闲的 vt. &vi. 游戏,戏弄,炫耀
tradition	n. 传统, 惯例
lake	n. 湖
national	adj. 国家的,民族的 n. 国民
finish	n. 完成,最后加工,结局,完美 vt. 结束,获...第几名 vi. 终结,完成
accompany	vt. 陪伴, 伴随，给...伴奏 vi. 伴奏
bind	vt. 绑,约束,装订,粘合
transport	n.运输、运输工具；(常用复数）强烈的情绪、狂喜或狂怒 vt. 运输；流放；为强烈的情绪所激动
roof	n. 屋顶, 顶盖 vt. 给...覆以屋顶,覆盖
display	n. 显示,陈列,炫耀 vt. 显示,表现,夸示
fix	vt. &vi. 使...固定,修理,准备 n. 困境, (船只、飞机等的)定方位,贿赂
star	n. 星, 明星 v. 以星状物装饰, 变成演员
network	n. 网络,系统,广播网 vt. 用网覆盖,联网 vi. 加入网络
flight	n.（物体的）飞行； 航班； 飞翔； 楼梯的一段 vi.成群地迁徙或飞行 vt.射击； 使惊飞
popular	adj. 大众的,流行的,有销路的
wage	n. 薪水,报偿,代价 vt. &vi. 开始,进行（战争、运动）
terrorist	n. 恐怖分子
negotiation	n. 谈判, 协商
steal	vt.偷； 悄悄地做，悄悄地走； 潜行； 不正当的获得 vi.偷； 偷偷地行动：秘密、不显明地行动、发生或消失； [棒球]偷垒 n.偷窃； 便宜货； 便宜货
rush	vi.（使）急速行进，仓促完成； 猛攻； 急速流动，奔腾 vt.突袭； （使）仓促行事； 催促； （为物色、招募目的）特别关注 n.冲； 匆忙； 繁忙的活动； 涌动
management	n. 管理(层),经营,处理
pursue	v. 追捕, 追求, 继续从事
smell	n. 味道,气味,嗅 vt. 闻,探出,发臭 vi. 闻,发臭
borrow	v. 借, 借入, 借用
leg	n. 腿, 支柱, 裤脚管 vi. 用脚走路
powerful	adj. 强有力的
collect	vt.收集； 收藏； 接走； 聚积 vi.募捐； 募集 adj.由受话人付费的
huge	adj. 巨大的,程度高的
negotiate	vt. 转让,越过,处理,协商 vi. 协商
fairly	adj. 公平地, 相当 adv. 相当地
salary	n. 薪水 vt. 给...薪水
score	n.得分； 分数； 总谱； 20个 v.得分； 记分； 评分； 获得胜利
twice	adv. 两倍, 两次
northern	adj. 北部的, 北方的
ice	n. 冰, 矜持 v. 冰冻, 结冰
liberal	n. 自由主义者, 宽容大度的人, (Liberal)自由党人 adj. 无偏见的, 慷慨的, 不拘泥的, 宽大的, 开明的
ultimately	adv. 最后,最终
lie	n. 谎言 v. 躺着, 说谎, 位于
stream	n. (人,车,气)流,水流,组 vt. 流出,飘动 vi. 流动,飘动,接踵而来
street	n. 街道 adj. 街道的
illness	n. 病, 疾病
remark	n. 备注,评论,注意 vt. 评论,注意,述及
novel	adj. 新奇的 n. 小说
benefit	n. 利益, 津贴; 义卖, 义演 vt. 有益于 vi. 得益
witness	vt. 目击,见证, 出席, 观察, 经历 n. 目击者,证人 vi. 为(宗教信仰)做见证, 证明
science	n. 科学
private	adj. 私人的，隐蔽的 n. 士兵，列兵
impossible	adj. 不可能的
prize	n. 奖品,珍品,战利品 vt. 重视 adj. 奖励的,杰出的
procedure	n. 程序, 手续, 步骤; 常规的做法
weather	n. 天气,气候,气象 vt. (因受风吹,日晒,雨淋等,使)褪色, 平安度过 vi. 变色,变形, 经受住(困难) adj. 天气预报的, 上风的
compare	vt.&vi. 比较,比喻,对照 n. 比较，对照
bird	n. 鸟,家禽,陶土飞靶,伙伴 vi. 观察或辨认鸟
unless	conj. 除非 prep. 除...外
succeed	vt. 成功,继承,继续 vi. 接替,有作为
success	n. 成功,发财，胜利，成功者，成功的事物
secret	adj. 秘密的,机密的 adv. 秘密地 n. 秘密
secretary	n. 秘书,部长,大臣,书记
essential	adj.基本的； 必要的； 本质的； 精华的 n.必需品； 基本要素； 必不可少的东西
army	n. 军队,陆军,大群
collection	n. 收藏品,收集物,小组,集合
arrival	n. 到达,达到,到达者
arrive	vi. 到达,成功
load	n. 负荷, 重担, 装载量 v. 装载, 装填, 担负, 给(枪)装子弹 [计算机] 装入
proper	adj. 适当的,正确的,合适的,正当的,规矩的
loan	n. 贷款, 借出, 债权人 v. 借, 供应货款, 借给
upon	prep. 在...上
fun	n. 乐趣,玩笑,有趣的人或事物 vi. 开玩笑 adj. 充满乐趣的,令人愉悦的
concept	n. 概念, 观念
protection	n. 保护,防卫
protest	n. 抗议, 反对, 抗议书 vi. 反对,抗议,断言 vt. 坚持地表示, 对...提出异议
proud	adj. 骄傲的, 自豪的, 壮观的
economy	n.节约； 经济； 理财； 秩序
surface	n. 表面,平面, 外表 adj. 表面的,肤浅的 vt. 在某物上加表层, 使...成平面 vi. 浮到水面, 披露出来, 在表面工作
gas	n. 煤气,气体,汽油,空话,能量 vt. 使吸入毒气,死,给...加汽油 vi. 空谈,加汽油
poll	n. 投票,民意测验,民意,票数 vt. 做民意测验,获得...票,剪树枝 vi. 投票
connection	n. 联系,关系,连接,亲戚
boss	n. 老板, 上司 v. 指挥, 控制
surround	n. 环绕物 vt. 包围,环绕
generally	adv. 一般地
generate	vt. 产生,发生,引起 [计算机] 产生
interview	n. 面谈,访问,接见 vt. 接见,对...进行面谈(试) vi. 面试, 采访
conservative	adj. 保守的,守旧的 n. 保守派(党),保守的人
undertake	vt. 从事,保证
box	n. 盒子,箱,专席,亭子,窘境 vt. 装...入盒中,限制住,调和,改变形状,用拳击... vi.参与拳击
vast	adj. 广阔的,巨大的 n. 浩瀚的太空
electricity	n. 电力；电流；强烈的紧张情绪
loss	n. 丧失, 损耗, 亏损
sweet	adj. 甜(蜜)的,新鲜的,可爱的,悦耳的 n. 糖,甜(点),令人高兴的东西 adv. 甜蜜地
achievement	n. 成就, 成绩, 完成, 达到
swim	游泳
swing	n. 摇摆,改变,冲力 vt. &vi. 摇摆,旋转,动摇
hot	adj. 热的,热情的,辣的,性感的 adv. 激动地,快速地 n. 最高温度,滚烫的东西
arm	n. 手臂, 港湾, 狭长地带, 扶手, 袖子, 枪 vt. 装备, 准备(炸弹) vi. 武装自己
bar	n. 条,棒,横木,酒吧 vt. 禁止,阻挠
emphasis	n. 强调,重点
contribute	vt. 捐助,投稿 vi. 投稿,贡献,是原因之一
village	n. 村庄
bridge	n. 桥,鼻梁,桥牌 vt. 渡过,架桥
bright	adj. 明亮的,阳光的,生动的,聪明的 adv. 亮 n. 亮色
mail	n. 邮件,邮政 vt. 邮寄
owe	v. 欠 vi. 欠钱 vt. 欠(债等),归功于,应感谢
sharp	adj. 刺耳的,锋利的,急剧的 adv. [时刻]正,准 夏普(财富500强公司之一，总部所在地日本,主要经营电子电气)
afterward	adv. 后来, 以后
quote	n. 引用 v. 引述, 举证, 报价
aid	n. 帮助,救护,辅助物 vt. &vi. 援助,帮助,救护 abbr.=Agency for International Development 国际开发署[美]
material	n. 材料, 原料, 物质; n. 素材, 题材, 资料 adj. 物质的, 实体的; 身体上的, 肉体的 adj. 重要的, 关键的
distinguish	vt. 区别,辨认,特别关注 vi. 区别
organize	vi. 组织起来 vt. 组织
art	adj. 美术(品)的,艺术(品)的 n. 艺术, 技术, 阴谋, 美术
contact	v. (与)联系, (与)接触 n. 接触, 联系; 联系人
glass	n. 玻璃, 玻璃器皿, 窗户, (复)眼镜,透镜 vt. 用玻璃把…盖（或罩、围）住,给...装上玻璃, 使成玻璃状, 反映, 反射, 审视 vi. 成为玻璃状, 用光学仪器眺望
soft	adj. 柔软的,温和的,不强烈的,细腻的,轻的 adv. 柔软地,温和地 n. 柔软的东西
ought	conj. 应该, 大概
suit	n. 套装, 诉讼, 请求 v. 适合, 取悦, 满足
equipment	n. 设备,装备
suitable	adj. 合适的, 适宜的
sick	adj. 恶心的, 有病的, 腻烦的, 晕的 n. 病人, 呕吐物 vt.追逐, 攻击; 唆使
initial	n. (词)首字母 adj. 开始的, 最初的, 字首的 vt. 签姓名的首字母于
reader	n. 读者，读物, 读本
critic	n. 批评家, 评论家
ready	adj. 准备好的,乐意的,情愿的，现成的 vt. 做好…的准备
disease	n. 疾病,弊端
significant	adj. 有意义的, 意味深长的; 相当数量的; 重要的, 重大的 n. (复)有意义的事物; 标志
fund	n.基金； 储备； 现款； 特别基金管理机构 vt.积存； 为…提供资金； 提供资金偿付（债款等）的本息； 把（短期借款）转为有固定利息的长期借款
similar	adj. 相似的,类似的,相同,一样
simple	adj. 简单的,无辜的,天真的,基本的,纯粹的 n. 平民,精神病人,草药
everyone	pron. 每人, 人人
goal	n. 目标，目的； 球门； 终点；
pace	n. 速度,步调,步法 vt. 踱步,调整节奏 vi. 缓慢地走
television	n. 电视
match	n. 比赛, 火柴, 对手, 般配的人, 配偶 v. 使...相配, 与...竞争, 相配
western	n. 西方人, 西部片, 西部小说 adj. 西方的, 西洋的, 西部的
choice	adj. 上等的,精选的 n. 选择,挑选
apartment	n. 一套公寓房间
whatever	pron.&amp;conj. 无论什么 adj. 不管怎样的 det. 不管什么,无论何事
intend	v. 打算 vt. 想要,打算,计划
reference	n. 参考, 出处, 参照 n. 推荐人, 推荐函 vt. 提供参考
measure	n. 措施, 办法, 量度, 尺寸 v. 测量, 量
approach	n. 接近; 途径, 方法 v. 靠近, 接近, 动手处理
territory	n. 领土, 版图, 领域, 范围
grant	vt.承认； 同意； 准许； 授予 n.拨款； 补助金； 授给物（如财产、授地、专有权、补助、拨款等） vi.同意
regard	vt.认为； 注视； 涉及； 尊敬 vi.凝视； 留意 n.凝视； 留意； 尊敬； 问候
interpretation	n. 解释,演出,翻译,互
gap	n. (意见、个性等的)差异,缝隙,漏洞,缺口 vt. 制造缺口 嘉普(财富500强公司之一，总部所在地美国,主要经营服装零售)
expand	vt. 增加,详述,扩展,使...膨胀 vi. 扩展,增加,详述
medium	n. 媒体, 方法, 媒介 adj. 适中的, 中等的
wife	n. 妻子,夫人
camera	n. 摄像机,照相机
relative	adj. 相对的,比较的,涉及到的 n. 亲属,同类事物,相关物
chemical	adj. 化学的 n. 化学制品
relevant	adj. 相关的, 切题的, 中肯的
invite	vt. 邀请,要求 n. 邀请
expose	vt. 暴露,揭穿,使遭受（危险或不快）
island	n.岛，岛屿 vt.使孤立
wire	n. 电线,铁丝网,电报 vt. 给…装电线,用电报发,用导线连接 vi. 发电报
extend	v. 扩充, 延伸, 伸展, 扩展
smile	n. 微笑,喜色 vt. 微笑,微笑地表示, 以微笑完成 vi. 微笑, 赞许, 一笑而过
itself	pron. 它自己, 它本身
guide	vt.引路； 指导； 操纵； 影响 n.指导者； 向导； 导游； 有指导意义的事物
depression	n. 沮丧,萧条
withdraw	vt. 撤回,取回,撤退 vi. 退回,撤退
facility	n.设备； 容易； 能力； 灵巧
decrease	n. 减少(量),降低 vt.& vi. 减少,降低
basically	adv. 基本上, 主要地
text	n. 本文, 文件, 正文, 课文 vt. &vi. 发短信
defend	vt. &vi. 防护,辩护,防卫
payment	n. 支付, 付款
wonderful	adj. 极好的, 精彩的
representative	adj. 代表性的, 代议制的, 典型的 n. 代表, 众议员, 典型
diet	n. 日常饮食，规定饮食 vt. 照规定饮食 adj. 低卡路里的
throw	n. 投,掷,抛, 头巾, 行程 vt. 丢,掷,抛,猛动,抬起,挥动 vi. 投以
mission	n. 任务,代表团,使命,传教 vt. 传教 [计算机] 使命
demonstrate	vt. 示范, 演示, 证明 vi. 示威
pension	n. 退休金,年金,抚恤金 v. 发给退休金
department	n. 部,部门,系
ticket	n. 票,券,标签 vt. 加标签于,售票
perfectly	adv. 完全地, 无瑕疵地, 完整地，完美地，圆满地
original	adj. 最初的, 原始的; 有独创性的, 原版的 n. 原件, 原稿; 有独创性的人, 怪人
investigation	n. 调查
restaurant	n. 餐馆,饭店
address	n. n.地址； 通信处； 演说； 称呼
photograph	n. 相片 vi. 照相,摄影 vt. 给...照相
device	n. 装置, 设计, 策略, 设备
mostly	adv. 大概, 大部份, 主要
yesterday	n.&amp;adv. 昨天
agenda	n. 议事日程
mouse	n. 老鼠,鼠标，胆小如鼠的人，乌青色的肿块 vi. 捕鼠，蹑手蹑脚行动 vt. 仔细寻找
soul	n. 灵魂, 精神, 美国黑人(或黑人音乐) adj. 美国黑人文化特性的
tone	n. 音调,语气,品质,调子,色调 vt. 使更健壮,装腔作势地说, 定调, 调色 vi. 调和(颜色), 呈现悦目色调
laughter	n. 笑, 笑声
zone	n. 地域,地带,地区 vt. 划分成带, 标出或指定成区, 用腰带围绕 adj. 地区性的, 地域上的
mechanism	n. 机制,原理，机械,机构,结构
touch	n. 触觉,接触,少许, 痕迹, 修饰 vt. 触摸,吃,喝,触及,感动 vi. 接触, 联系
fifty	num. 五十
dinner	n. 主餐, 晚餐, 晚宴
plane	n.水平； 平面； 飞机； 木工刨 adj.平的，平坦的 vt.用刨刨平； 小船等擦着水面疾驶 vi.鸟滑翔
uniform	adj. 一致的,统一的 n. 制服 vt. 穿制服
enhance	vt. 提高,加强,增加
plate	n. 碟,盘,金属板,板块 vt. 镀金,电镀,为...制印版,, 给...装钢板,用金属板固定
traditional	adj. 传统的
spring	n. 春天, 弹簧, 弹跳, 泉水, 投射 vt. 弹起, 使喷涌, 越过, 弹出, 释放, 发生, 跳, 裂开 vi. 射出, 涌入(出), 发芽, 长高
relation	n. 关系,家人,亲戚,叙述,陈述
roll	vt.辗； 使（眼球等）左右转动； （使）原地转圈； 滚动 vi.左右摇晃； 翻滚； 开始移动，启动 n.名册； 滚翻
hero	n. 男主角, 男主人公, 英雄
natural	adj.自然的； 物质的； 天生的； 不做作的 n.自然的事情； （生来的）白痴； [乐]（风琴等的）白键
basic	adj.基本的； [化学]碱性的； [地质学]基性的； 首要的 n.基础，基本； 基本原则，基本原理，基本规律； 要素； 基础训练
fire	n. 火,火灾,射击 v. 点燃,解职,开枪
participate	vi.参加某事； 分享某事 vt.得到或接受某部分东西
plus	prep.（表示运算）加； （表示包容）外加； [口语]和； （表示数目）在零（度）以上 n.加号； [数学]正量； 好处； 附加物 adj.加的； 正的； 附加的； 比所示数量多的
resolution	n.决心； 解决； 坚决； 分辨率
claim	n. 要求,要求权;主张,断言,声称;要求物 vt. 要求,请求；主张,声称,断言
round	n. 圆,(某种圆形)交谊舞,常规活动,一局(轮) adj. 圆的,微胖的,完整的,坦率的,圆满完成的 adv. 环形地 vt. 弄圆,绕行,使...完全,使成为整数 vi. 变圆(胖),弯曲 prp. 围绕,遍及
dispute	n. 争论; 争吵 vi. 争论, 争执 vt. 争论; 质疑; 争夺; 抵抗
distribution	n. 分发, 分配, 散布, 分布
lawyer	n. 律师
lay	lie的过去式 vt.放置； 铺放； 涂，敷； 产卵 adj.世俗的； 外行的； 没有经验的 n.叙事诗； 性伙伴
distribute	vt. &vi. 分配,散布
trial	n.试验； [法]审讯，审判； 磨难，困难； [体]选拔赛 adj.试验的； [法]审讯的
moreover	adv.再者； 此外； 而且； 同时
trip	n. 旅行,摔倒,差错,轻快的步伐 vt. 使跌倒,使犯错,使失败,起锚,竖帆 vi. 轻快地走,绊倒,失误,结巴,旅行
poor	adj.贫穷的，贫乏的； 令人怜悯的，可怜的； 匮乏的； 低劣的 n.the poor 贫困者，穷人
floor	n. 地板,楼层,底部,地面,议员,底线 vt. 铺地板,击倒,油门踩到底
news	n. 新闻, 消息
flower	n. 花,华丽,盛年,精英,自然发展的结果 vi. 成熟,开花 vt. 使开花,用花装饰
abroad	adj. 在国外,海外(一般作表语) adv. 到国外, 广为流传
steady	adj. 稳定的,稳固的,沉稳的 adv. 平稳地,稳固地 n. 固定的事物 vi. &vt. (使)稳固,(使)稳定
presentation	n. 陈述, 介绍, 赠与 n. [美]讲课, 报告
scientific	adj. 科学的
club	n. 击棍,扑克牌中的梅花,俱乐部 vt. 用棍棒打,集合 vi. 集合,分担花费,泡夜总会
act	n. 行为,行动,法案,（戏剧、歌剧等的）一幕 vt. 表演,扮演 vi. 表演,行动,表现,充当,奏效
active	adj. 积极的；活跃的；主动的；有效的；现役的 n. 主动语态；积极分子
stick	vt.& vi.粘贴； 张贴； 插入； 刺入 vt.容忍； 产生作用； （尤指迅速或随手）放置； 阻延或推迟 n.棍棒，棍枝； 枝条； 操纵杆； 球棍
actual	adj. 实际的,真实的
isolate	adj. 孤立的 v. 隔离,孤立 vt. 使隔离,使孤立
safe	adj. 安全的 n. 保险箱
specifically	adv. 特定地,明确地
lesson	n. 课，教训 vt. 给...上课,教训
husband	n. 丈夫 vt. 节俭
statement	n. 声明, 陈述
twelve	adj. 十二,12,12
dear	adj. 严重的,珍贵的,亲爱的,昂贵的,衷心的 adv. 高价地,热爱地 n. 亲爱的人,可爱的人 int. 啊,哎呀
twenty	adj. 二十,20,20
afraid	adj. 害怕的, 担心的
commitment	n. 委托,实行,承诺,保证(律）拘禁令，奉献，献身
satisfy	vt. 使...满意, 使...信服 vi. 足够, 取悦
straight	adj. 直的, 准的, 正直的, 坦率的, 连续的 adv. 直接, 笔直地, 平正了, 坦率的, 连续不断地 n. 直的东西, 传统的人
forest	n. 森林,园林,林火 vt. 用树林覆盖, 植树
educational	adj. 教育的，有教育意义的
unable	adj. 不能的,不会的 v. 不能,不会
style	n. 风格,时尚,字体 vt. 称呼,设计
alive	adj. 活着的,有活力
online	n.联机, 在线
communication	n. 沟通,交通,沟通
labor	n. 工作, 劳动, 劳力, 劳方 vt. 苦干, 劳动, 分娩, 阵痛, 致力于 vi. 过分详尽阐述 adj. 劳工的, 劳动的
immediately	adv. 立即,直接地 conj. 一...(就)
amount	n. 数量, 总额 vi. 总计, 等于
besides	prep. 除...之外 adj. 别的 adv. 也,此外
participant	adj. 参与的 n. 参加者,参与者
ancient	adj. 古代的,古老的 n. 古人, 古货币
anger	n. 怒，愤怒；忿怒 vt. 使发怒，激怒；恼火 vi. 发怒；恼火
link	n. 环节,联系, (链的)环, 圈 vt. &vi. 连接,联系
favorite	adj. 流行的，喜爱的 n. 最喜爱的人或物, 被认为最有可能胜出的竞争者
improvement	n. 改进, 改善
bill	n.账单； 钞票； 清单； 广告 vt.安排； 给…开账单； 为…发提（货）单； 把…登录在账 vi.鸟嘴相接触
list	n.清单，目录； 倾斜； 布边，布头； 狭条 vt.列出，列入； 把…编列成表； 记入名单内 vi.列于表上
university	n. 大学
professor	n. 宣称者,教授
profit	n. 利润, 盈利比率，利益 vi. 利用，获利 vt. 有益于
output	n. 产量,输出,输出功率,输出端 vt. 输出(信息等)
section	n. 零件,部分,章节,区域,部门,路段,断面 vt. 划分,切开 vi. 划分
component	n. 元件, 组件, 成份 adj. 组成的, 构成的
premise	vt. 引出，预先提出；作为…的前提 n. 前提；上述各项；房屋连地基 vi. 作出前提
dynamic	adj. 动态的, (有)动力的, (有)力的; 有活力的 n. 动力; 力学
global	adj. 全球性的, 全局的
suggestion	n. 建议, 意见, 迹象, 暗示, 联想
gene	n. 基因
concentrate	vt.& vi.专心于； 注意； 集中； 聚集 vt.浓缩，（使）浓缩； [采矿]汰选； 选矿，精选，富集 vi.凝缩，浓缩，提纯 n.浓缩物 adj.集中起来的，经过浓缩的
propose	v. 计划, 打算, 向...提议; 求婚
officer	n. 官员,军官 vt. 提供官员,指挥
okay	n.认可，同意 v.赞成或同意； 批准 int.行，用以表达准许或同意之意 adj.可以，不错
attention	n. 注意(力),关心,立正
prove	v. 证明, 查验, 显示
prior	adj. 更重要的, 较早的, 在先的 adv. 居先 n. 小修道院院长; 大修道院副院长
bond	n. 债券；结合；约定；粘合剂 vi. 结合，团结在一起 vt. 使结合；以…作保
editor	n. 编辑, 编者
perception	n. 感知, 认识, 观念
effective	adj. 有效的,有影响的
qualify	vt. 取得资格,有资格,限定,描述 vi. 取得资格, 有资格
serve	v. 可作...用, 服务, 对待, 发球 n. 发球
boy	n. 男孩,儿子
purpose	n. 目的, 意图; 意志, 决心; 议题 vt. 打算, 决意
consistent	adj. 始终如一的, 一致的, 坚持的
acquire	vt. 占有,获得,取得,学到
lovely	adj. 可爱的,令人愉快的 n. 漂亮的女人,美好的东西
switch	n. 开关, 电门，闸，转换器, vt. &vi. 鞭打，转轨，交换，突然转变, 摆动，接通或切断…电流
settle	n. 有背的长凳 vt. 安放,安顿,解决,决定,付清(欠款) vi. 定居,降落
emerge	vi. 浮现, (由某种状态)脱出, (事实)显现出来
luck	n. 运气,幸运,吉祥之物 v. 侥幸成功
victim	n. 受害者,牺牲
emotional	adj. 感情的, 情绪的
emphasize	v. 强调,着重 vt. 强调
breathe	vi. 呼吸 vt. 轻声说,流露感情,注入
employer	n. 雇主
onto	prep. 到...上
empty	adj. 空的,空虚的,空腹的 n. 空物 vt. 使...空 vi. 变空,流入
operation	n. 手术, 行动，活动, 操作
pub	n. 酒吧, 酒馆
debate	n. 辩论,讨论 vt. 争论,思考 vi. 商讨,辩论
disappear	vi. 消失,灭绝 vt. 引起消失
dramatic	adj. 戏剧性的,引人注目的,给人深刻印象的
chief	adj. 主要的, 首席的 n. 首领
rank	n. 队列,排名,等级,军衔,阶级 adj. 繁茂的,恶臭的,讨厌的 vt. 排列,归类于
talent	n. 才能, 人才, 天资
crash	v. 撞碎, 猛使...破碎, 迫降，发出巨响 n. 轰隆声, 猛撞, 崩溃, 破产, 垮台 adj. 速成的 n. 粗布
error	n. 错误, 过失
male	adj. 男性的,雄性的 n. 男子,雄性动物
manage	vt. 管理,处理,维持,达成,经营 vi. 管理,达成
credit	n. 信用, 荣誉, 贷款, 学分 v. 归功于, 赞颂, 信任
tape	n. 录像带, 录音带, 磁带, 胶带 vt. 用带子捆起, 给...录音 vi. 录音
task	n. 工作,任务 vt. 交给某人（任务)
location	n. 地点,位置
taxi	n. 计程车，出租汽车 v. 用出租车运送，乘计程车，（飞机）滑行
hang	vt.悬挂； （被）绞死； 贴，装饰； 使悬而未决 vi.悬垂； 被吊死； 附属，依靠； 悬而未决 n.悬挂的样子； （动作的）暂停； 〈口〉大意，要点； 〈口〉做法，诀窍
eventually	adv. 终于, 最后
crop	n. 庄稼,收成, 一群,平头 vt. 割掉, 修剪, 剪短, 收割, 使谷物生长 vi. 啃青草, 种植谷物
reasonable	adj. 合理的,有道理的,适度,通情达理的 adv. 合理地
advertise	vi. 登广告 vt. 为...做广告, 宣传
marriage	n. 婚姻,结婚
release	n. 释放, 让渡, 发行 vt. 释放, 让与, 准予发表, 发射
sing	vt. 唱,鸣唱,用诗赞美,叫,响 vi. 唱歌 n. 合唱
sensitive	adj. 敏感的,灵敏的,易受伤害的,感光的,善解人意的 n. 敏感的人
wake	vt. 守灵,叫醒,醒来 vi. 醒,叫醒 n. 清醒,守护神节日,守灵,尾流,后果
cup	n. 杯子 v. (使)成杯形 vt. 使成杯形
recover	vt.恢复； 重新获得； 找回； <正>恢复（适当的状态或位置） vi.恢复健康（体力、能力等） n.恢复开始时姿势
toy	n. 玩具,小玩意儿 adj. 供玩耍的,体型小的 vi. 漫不经心地做,戏弄
repertoire	n. (准备好演出的)节目, 保留剧目, (计算机的)指令表, 指令系统, &lt;美&gt;(某个人的)全部技 能, 清单,指令表
initiative	adj. 创始的, 初步的, 自发的 n. 第一步, 首创精神; 主动权
size	n. 尺寸, 大小 vt. 按大小排列(或分类) adj. 一定大小的 vt. 用...填充(某物)
tension	n. 紧张,张力,拉力 vt. （使金属线、帆等）拉紧
theater	n.剧场； 戏剧界； 戏剧效果； [军]战区
secondly	adj. 第二(点),其次 adv. 第二,其次
store	n. 商店,贮藏,仓库 vt. 储存,贮藏,供给,保存 adj. 储备的 (在计算机里)存贮；记忆
meat	n. 肉,主要或重要部分
danger	n. 危险
daughter	n. 女儿 adj. 与女儿有关的, 女性直系后代的
expert	adj. 熟练的,内行的 n. 专家,能手 vi. 当专家
voter	n. 投票人, 选举人
explanation	n. 解释, 说明
theory	n. 理论,原则,看法,推测
explore	vt. &vi. 探险,探测,探究
export	vt. 输出，出口 n. 出口,输出品 vi. 传播,输出 adj. 出口的
religious	adj. 宗教的,虔诚的,细心的 n. 修道院成员, 僧侣
contribution	n. 贡献,捐款(赠)
wish	n. 渴望,愿望,(复数)祝颂,命令 vt. &vi. 想要,希望
guest	n. 客人, 客串演员, 特邀来宾 vt. 款待 vi. 作客
smoke	n. 烟, 无常的事物, 抽烟 v. 吸烟, 以烟熏, 冒烟
snow	n. 雪,似雪花的东西,粉状物,下雪 vi. 下雪 vt. 像雪一般落下,使雪白,欺骗
remove	n. 间距, 移动 vt. 除去,开除, 移动, 取下, 拿走 vi. 迁徙,离开,搬迁
habit	n. 习惯，习性；嗜好 vt. 使穿衣
pause	n. 暂停,中止,犹豫不决 vi. 停顿,中止 vt. 使停顿
repeat	n. 重复,反复 vt. 重复,复述 vi. 重复 adj. 重复的,反复的
stable	adj. 稳定的；牢固的；坚定的 n. 马厩；牛棚 vi. 被关在马厩 vt. 赶入马房
assure	vt. 保险,保证,确信,担保
fair	adj. 公平的, 晴朗的, 美丽的; 相当的 adj. (皮肤, 毛发等）浅色的; 白皙的 n. 展览会, 市集 adv. 公平地; 直接地
journey	n. 旅程, 旅行, 行程 v. 旅行
wood	n.木材； 树林； 木制品 vi.收集木材 vt.在…植树造林； 给…添加木柴 adj.木制的； 失去理智的
badly	adv. 严重地, 恶劣地, 极度地
soil	n. 土地,土壤 v. 弄脏,(使)变脏 vi. 变脏 vt. 弄脏
count	v. 计算, 视为, 依赖 n. 计数
request	n. 要求, 请求 vt. 请求, 要求
jump	n. 跳跃,跳动,上涨 vt. &vi. 跳越,突升,惊跳
worker	n. 工人，工作者
solve	v. 解答(难题),解决 vt. 解答,解决
worry	n. 烦恼,忧虑,苦恼 vt. 使...烦恼,使...焦虑, 叼住某物甩或拉 vi. 感到苦恼,感到焦虑
justify	vt. 替...辩护,证明...正当 n. 对齐 [计算机] 调整
percentage	n. 百分率,比例,可能性
derive	v. 得自, 起源, 引申于
tight	adj. 紧的, 严厉的,密集的,紧身的,拮据的 adv. 紧紧地,牢固地, 迅速地
response	n. 反应, 响应; 回答
hat	n. 帽子,职位 vt. 给...戴帽子 vi. 提供帽子
tire	n. 轮胎.金属圈 vt. 使疲倦, 厌烦 vi. 疲劳
gay	adj. 欢快的, 色彩鲜艳的, 同性恋的 n. 同性恋
access	n.入口，出口； 接近，进入； 增长； 爆发 vt.接近，进入； 使用，接近，获取
seriously	adv. 认真地, 严肃地, 严重地
ignore	vt. 不顾,不理,忽视
necessarily	adv. 必然地,必定地，必需地
chair	n. 椅子,席位,讲座,要职 vt. 上任,使担任（某事务）的主席,主持
phrase	n. 短语,习语,个人风格,乐句 vt. 措词表达,将(乐曲)分成乐句(来演奏)
attach	v. 附上, 系上, 贴上, 使依恋
balance	n. 天平, 平衡, 差额, 平静, 调和, 制衡 vt. 使平衡, 称重量, 权衡, 抵消 vi. 建立平衡, 均衡
federal	adj. 联邦的 n. 同盟盟友
review	n. 检讨, 复习, 回顾, 评审 vt. 温习, 检讨, 评论, 检阅 vi. 写评论
band	n. 带;箍,队,乐队 vt. &vi. 联合,结合
version	n. 版本, 说法，翻译
eliminate	v. 除去,排除,剔除 [计算机] 消除
mouth	n. 嘴,开口，需要供养的人，夸张说话的趋势，（河流等）入口，容器的开口 vt. 装腔作势说话, 送进嘴里，喃喃自语，用唇语说 vi. 傲慢地说，嘟嘴扮鬼脸
specialist	n. 专家
attitude	n. 态度, 看法, 姿势
dog	n. 狗,卑鄙的人 vt. 尾随,跟踪
emotion	n. 情感,情绪,感动
audience	n. 听众, 观众, 读者, 拥护者, 倾听, 正式会见
cope	v. (with)竞争,对抗,对付,妥善处理 vi. 对付,妥善处理
magazine	n. 杂志
tough	adj. 强硬的, 艰苦的, 棘手的, 严厉的 adv. 以强硬的态度 n. 暴徒; 恶棍
quick	adj.快的，急速的； 聪明的，凌厉的； 灵活的； 短时间做成的 adv.迅速地，快速地 n.（指甲下的）活肉； 感情的中枢，感觉最敏锐的地方； 要害，核心
quiet	n. 安静,闲适,平静 adj. 安静的,静止的,宁静的 adv. 安静地 vt. &vi. 使...平静,使...安心
plant	n. 植物，设施，设备，工厂 v. 种植，建立，设立
finally	adv. 最后, 最终
financial	adj. 金融的,财政的
coach	n. 大巴, 教练; (火车)客车车厢, 四轮马车, 经济舱 vt. 训练, 指导 vi. 训练, 指导
radio	n. 收音机,无线电 vt.& vi. 用无线电通讯
estate	n. 财产,房地产,状态,遗产
purchase	n. 购买, 购买的物品 n. 支点; 紧握, 抓紧 vt. 购买, 赢得; (用设备)举起, 移动
citizen	n. 公民, 市民
rain	n. 雨(水), (复数)雨季 vi. 下雨 vt. 使大量落下
recently	adv. 最近
wall	n. 墙壁,垣,绝境 vt. 堵塞, 分割, 用墙围住, 演戏般地转动(眼睛) vi. 演戏般地转动(眼睛)
travel	n.旅行,移动 vi. 旅行,传播,移动 vt. 横贯
hire	vt.聘用； 录用； 雇用； 租用 vi.受雇； 得到工作 n.租金； 酬金，工钱； [非正式用语] 被雇佣的人； 销售部的两个新雇员
ban	n. 禁令 v. 禁止 vt. 禁止,取缔
historical	adj. 与历史有关的
intellectual	n. 有知识者,知识份子,凭理智做事者 adj. 智力的,知性的,聪明的
routine	n. 例行公事, 常规，无聊 adj. 常规的, 例行的，乏味的
oppose	vt. 反对,以...对抗,抗争
alter	v. 改变
alternative	adj. 两者择一的; 供选择的; 非主流的 n. 替换物, 取舍
division	n. 区分,分开,除法,公司,部门，师（军队里）
clock	n. 时钟, 计时器
honest	adj. 诚实的,正直的 adv. 老实说
analysis	n. 分析, 解析
sign	n. 符号, 正负号, 手势, 迹象, 招牌 v. 签, 做手势, 做标记
criticism	n. 批评,评论
creation	n. 创造, 创作
cloud	n. 云,云状的烟，阴影 vt. 使…模糊，以云遮敝,笼罩，使…混淆,毁坏 vi. 脸色显得阴沉
marry	vt. &vi. 结婚,结合
hotel	n. 旅馆，宾馆，酒店，饭店
whereas	conj.&amp;adv. 然而,却,反之
anyway	adv. 不管怎样
sister	n. 姐妹，护士长
sail	n. 帆,乘船航行 vt. 乘船航行,浮游,启航 vi 驾船航行
hence	adv. 今后, 从此, 因此, 所以
hunt	n. 狩猎, 追捕, 搜寻 v. 狩猎, 打猎, 搜索
afford	vt. 提供,负担得起的(后果,损失等),给予
sample	n. 样品,标本 vt. 采样,品尝 adj. 样例的
meanwhile	adv. 同时 n. 其时,其间
sleep	n. 睡眠,静止,睡意 v. 睡觉,睡眠,静止
dance	n. 跳舞, 舞蹈, 舞会, 舞步 vi. 跳舞, 雀跃 vt. 使跳跃, 使某人以跳舞的方式进入
strength	n. 力量,力气,长处,强度
ill	adj. 坏的,有病的,引起痛苦的,敌意的 adv. 恶劣地,勉强的 n. 邪恶,不幸,祸害,坏话
previous	adj. 在...之前, 先, 前, 以前的
ad	abbr. 广告；公元（AD）
investigate	vt. &vi. 调查,研究 [计算机] 研究
relatively	adv. 比较地, 相对地
wine	n. 酒,葡萄酒,紫红色 vt. &vi. 喝酒,请喝酒
enjoy	vt. &vi. 享受,喜欢
express	n. 快车, 快递, 专使 adj. 急速的, 明确的, 直接的 adv. 用快递; 特意地 vt. 表达, 表示; 挤压出; 快递
unfortunately	adv. 不幸地
communicate	vt. 传达, 传播 vi. 交流, 沟通, 联通
external	n. 外部 adj. 外部的,外用的,客观的,表面的
union	n. 联盟,结合,政党,工会,连接轴 adj. 联邦政府的,工会的
signal	n. 信号,导火线,动机 vt. 发信号,标志 vi. 发信号 adj. 显著的
dry	adj. 干的，干燥的,干旱的，不行于色的，枯燥无味的，无酒的，口渴的 vt. 把...弄干 vi. （使）变干
comparison	n. 比较
factor	n. 因素,因子 vt. 把…因素包括进去 vi.作为因素
emergency	adj. 紧急的 n. 紧急情况,突发事件
security	n.安全； 保证，担保； 保护，防护； 有价证券 adj.安全的，保安的，保密的
mine	pron.(I的所有格)我的（东西） n.矿； 矿井； 地雷； 水雷 vt.& vi.在…中开采，开采 vt.在…中[下]布雷； 以地雷[水雷]炸毁
accident	n. 事故,意外的事
supporter	n. 支持者，抚养者，支撑物
represent	vt. 表现, 表示, 描绘, 代表 vi. 提出异议
minority	n. 少数, 少数民族, 未成年
personality	n. 个性, 名人, 特色
seek	n. 找寻 v. 寻求,寻找,搜索
throughout	adv. 到处, 自始至终 prep. 遍及, 贯穿
lock	n.锁； 水闸，船闸； （机器部件等的）锁定； 一把，一撮 vt.锁上； 锁好，关好； 使固定； 隐藏 vi.卡住，不动； 纠结； 僵硬不动
summer	adj. 夏季的 n. 夏天, 全盛期, 年 vi. 度过夏天 vt. 在夏天保存或存放, 放(羊/牛)
blue	adj. 蓝色的,沮丧的,忧郁的,(女人)有学问的 n. 蓝色 vt. 使...变蓝 vi. 变蓝
attend	vt. 参加,注意,照料 vi. 专心,留意,待命
virtually	adv. 几乎,实际上
educate	v. 教育,培养 vt. 教育
average	n. 平均数,平均水平 adj. 一般的,通常的,平均的 vt. &vi. 取平均值，达到平均水平
knock	n. 敲,敲打 vt.& vi. 敲击,互撞,攻击
publication	n. 出版, 发行, 出版物, 公布, 发表
conflict	n.冲突； 战斗； 相互干扰； 矛盾 vi.抵触； 争斗； 战斗； 冲突
description	n. 描写, 描述, 说明书, 作图 n. 类型
occupy	vt. 占领,占,住进